fawn	faun
succour	sucker
tolled	told
saver	savour
foul	fowl
four	4 for fore forth fourth
muzzle	muscle mussel
seventy-seven	77
caddie	caddy
auk	orc
presents	presence
swat	swot
bays	baize
daze	days
lore	law
pride	pried
humerus	humorous
lack	lac
phial	file
we'll	weal wheel
magnate	magnet
prize	pries
suite	suit sweet
harrier	hairier
clothes	close cloze
overdo	overdue
nigh	nye
blue	blew
toll	tole
new	gnu knew
mints	mince
told	tolled
sixty-eight	68
whose	who''s who's
here	hear
herd	heard
100	one hundred
aren't	ant aunt
taper	tapir
galop	gallop
allready	already
lade	laid
prints	prince
elude	allude
patience	patients
ninety	90
yore	yaw you''re you're your
would	wood
browse	brows
idyll	idle idol
arms	alms
orc	auk
call	caul
holy	holey wholly
wart	wort
muse	mews
99	ninety-nine
98	ninety-eight
91	ninety-one
90	ninety
93	ninety-three
92	ninety-two
95	ninety-five
94	ninety-four
97	ninety-seven
copse	cops
shoot	chute
room	rheum
twenty-one	21
rood	rude rued
worn	warn
ere	air heir
wort	wart
guise	guys
root	route
wane	wain
sixty-four	64
assent	ascent
want	wont
guarantee	guaranty
hoe	ho
end	an and
chilly	chile chili chilli
auger	augur
very	vary
toxin	tocsin
gate	gait
beach	beech
gamble	gambol
lam	lamb
vicious	viscous viscus
lac	lack
eighty-eight	88
lax	lacks
lay	lei ley
law	lore
scull	skull
complacent	complaisant
guerilla	gorilla guerrilla
galipot	gallipot
belle	bel bell
aloud	allowed
wine	whine
cession	session
vary	very
censer	censor censure sensor
caster	castor
mayor	mare
fir	fur
personal	personnel
fie	phi
shear	shearn sheer
then	than
eighty-six	86
break	brake
band	banned
disburse	disperse
tacet	tacit
bread	bred
rumour	roomer
meat	meet mete
thyme	time
choir	quire
each	either
side	sighed
mean	mien
wheel	we'll weal
hanger	hangar
nave	knave
whig	wig
aide	aid
taught	taut tort
we'd	weed
whit	wit
hostel	hostile
psychic	physic physique
waive	wave
forty	40
laid	lade
adapt	adept adopt
lain	lane
twenty-five	25
forth	4 for fore four fourth
grease	greece
mourning	morning
knit	nit
aisle	i'll isle
ate	8 eight
licker	liquor
days	daze
bated	baited
bite	bight byte
already	allready
twenty-two	22
officious	official
grade	grate great grid
hoop	whoop
fissure	fisher
bitten	bittern
tor	tore
carrel	carol
tow	2 to toe too two
ton	tun
eighty-two	82
airy	aerie eerie
toe	2 to too tow two
ceiling	sealing
paltry	poultry
tool	tulle
cereal	serial
chantey	shanty
spayed	spade
guild	gild
coward	cowered
trey	tray
idle	idol idyll
guilt	gilt
sees	seas seize
seer	sear sere
mind	mined
raw	roar
seed	cede
manner	manna manor
rap	rapped rapt wrap wrapped
seen	scene
seem	seam
spade	spayed
cheep	cheap
horde	hoard
indite	indict
whee	we wee
phase	faze
coin	coign
doh	doe dough
pre-emptory	peremptory
flow	floe
doe	doh dough
aunt	ant aren't
principle	principal
floe	flow
bait	bate
queen	quean
undue	undo
gauge	gage
wrung	rung
peddle	pedal
bail	bale
hoard	horde
do	dew due
sense	census
forty-nine	49
whirled	world
gored	gourd
patten	paten pattern
earn	urn
braze	braise brays
boarder	border
bay	bey
rune	ruin
tole	toll
rung	wrung
steak	stake
steal	steel
blew	blue
fair	fare
wrest	rest rust
prophesy	prophecy
clew	clue
nun	none
fain	feign
accede	exceed
away	aweigh
sail	sale
cloze	close clothes
sere	sear seer
forty-three	43
claws	clause
we	wee whee
wears	wares
mcintosh	macintosh mackintosh
wean	ween
weal	we'll wheel
weak	week
fifty-seven	57
extent	extant
cousin	cozen
laze	lase
bray	brae
brae	bray
dents	dense
genus	genius
coo	coup
tough	tuff
vain	vane vein
gopher	gofer
trust	trussed
stares	stairs
putt	put
petty	petit petite
basis	bases
sixty-seven	67
three	3
been	bean
confident	confidant
beer	bier
beet	beat
idol	idle idyll
threw	through
barque	bark
chile	chili chilli chilly
chili	chile chilli chilly
naval	navel
gnu	knew new
lessen	lesson
air	ere heir
lesser	lessor
ail	ale
aid	aide
aural	oral
prostrate	prostate
precede	proceed
twenty-four	24
seven	7
kohl	coal
brewed	brood
elicit	illicit
eighteen	18
brake	break
jest	gist
in	inn
trustee	trusty
grown	groan
descent	dissent
parish	perish
synch	sink
perimeter	parameter
moose	mousse
jamb	jam
rain	reign rein
nix	nicks
tope	taupe
he'll	heal heel
nit	knit
peremptory	pre-emptory
thirty-four	34
jean	gene
capitol	capital
crewel	cruel
bruise	brews
greys	graze
farther	father
facts	fax
yew	ewe you
royal	roil
ewes	use yews
hay	hey
wretch	retch
board	bored
brays	braise braze
haw	hoar whore
seventy-five	75
quire	choir
discreet	discrete
birth	berth
gofer	gopher
59	fifty-nine
58	fifty-eight
55	fifty-five
54	fifty-four
57	fifty-seven
56	fifty-six
51	fifty-one
50	fifty
53	fifty-three
52	fifty-two
fifty-six	56
night	knight
eyelet	islet
augur	auger
valence	valance
grizzly	grisly
right	rate rite wright write
creek	creak
born	borne
dear	deer
bore	boar
cede	seed
dense	dents
tracked	track tract
for	4 fore forth four fourth
cord	chord cored
core	caw corps
knew	gnu new
bold	bowled
peel	peal
popular	poplar
phew	few
burr	bur
peer	pier pure
littoral	literal
joule	jewel
bury	berry
presentiment	presentment
census	sense
plum	plumb
rigor	rigger
meddle	medal metal mettle
bate	bait
formerly	formally
presence	presents
marshall	marital marshal martial
lien	lean
sol	sole soul
son	sun
wrack	rack
sow	saw sew so soar sore
lieu	loo
wrap	rap rapped rapt wrapped
awe	oar oh or ore owe
jealousy	jalousie
fought	fort
rapped	rap rapt wrap wrapped
way	weigh whey
crews	cruise
war	wore
fizz	phiz
marten	martian martin
some	sum
heal	he'll heel
libel	liable
fore	4 for forth four fourth
hear	here
beech	beach
fort	fought
duel	dual
flecks	flex
martial	marital marshal marshall
gneiss	nice
furs	furze
petit	petite petty
guessed	guest
check	cheque
dying	dyeing
floor	flaw
glacier	glazier
stake	steak
reality	realty
role	roll
whet	wet
whey	way weigh
roll	role
tic	tick
tasteful	tasty
toad	toed towed
polity	policy
reign	rain rein
troupe	troop
warn	worn
forty-two	42
roomer	rumour
faze	phase
navel	naval
phiz	fizz
gorilla	guerilla guerrilla
time	thyme
paced	paste
overdue	overdo
corps	caw core
roo	roux rue
millinary	millinery
baited	bated
forty-six	46
mill	mil
primer	primmer
hole	whole
row	rho roe
ware	wear where
father	farther
environment	ecology
mackintosh	macintosh mcintosh
96	ninety-six
me	mi
berth	birth
mourn	morn
brows	browse
wore	war
sighed	side
tear	tare tier
die	dye
levee	levy
magnet	magnate
discrete	discreet
team	teem
sixty-five	65
porn	pawn
mi	me
pore	poor pour
sign	sine
currant	current
upped	up
hymn	him
choral	coral
seventy-four	74
axes	axis
current	currant
axel	axle
bawled	bald
wain	wane
wail	wale whale
ninety-nine	99
genes	jeans
gnaw	naw nor
ingenuous	ingenious
hoarse	horse
wait	weight
boy	buoy
thirty	30
eke	eek
twenty-seven	27
bow	beau bough
queue	cue kyu
yoke	yolk
macintosh	mackintosh mcintosh
islet	eyelet
aye	eye i
by	buy bye
complaisant	complacent
bases	basis
prey	pray
dowse	douse
altar	alter
clue	clew
virtue	virtu
realty	reality
terce	terse
prophecy	prophesy
flu	flew flue
soul	sol sole
incidents	incidence
bowled	bold
thirty-five	35
ferry	fairy
coral	choral
heart	hart
accessary	accessory
nock	knock
locks	lox
council	counsel
allowed	aloud
chic	sheik
thirty-three	33
kyu	cue queue
rays	raise raze
1	one won
forty-one	41
parameter	perimeter
purl	pearl
cowered	coward
levy	levee
maw	moor more
eighty	80
bawl	ball
accessory	accessary
missal	missile
guys	guise
waist	waste
marshal	marital marshall martial
tale	tail
so	saw sew soar sore sow
talk	torque
serge	surge
yule	you'll
course	coarse
stile	sty style
lyre	liar
shake	sheikh
braid	brayed
tore	tor
mantle	mantel
he'd	heed
maid	made
policy	polity
mail	male
main	mane
disparate	desperate
nob	knob
hale	hail
not	knot
hall	haul
nor	gnaw naw
wont	want
tern	turn
bullion	bouillon
kerb	curb
brews	bruise
giro	gyro
summary	summery
canvas	canvass
profit	prophet
sensor	censer censor censure
gaffe	gaff
byte	bight bite
ore	awe oar oh or owe
seventy	70
manikin	mannequin
flare	flair
deprivation	depravation
gaff	gaffe
seventy-three	73
turn	tern
place	plaice
wright	rate right rite write
feign	fain
clause	claws
foaled	fold
intrastate	interstate
shearn	shear sheer
ring	wring
size	sighs
sheer	shear shearn
caught	court
callous	callus
2	to toe too tow two
draft	draught
persecute	prosecute
white	wight
cite	sight site
douse	dowse
hue	hew
quay	key
revue	review
wax	whacks
cops	copse
ninety-seven	97
butt	but
than	then
11	eleven
10	ten
13	thirteen
12	twelve
15	fifteen
14	fourteen
17	seventeen
16	sixteen
19	nineteen
18	eighteen
serf	surf
r	are
were	whirr
and	an end
villein	villain
slay	sleigh
sac	sack
few	phew
alley	ally
ant	aren't aunt
fifty-eight	58
borough	burro burrow
saw	sew so soar sore sow
castor	caster
knead	kneed need
cantor	canter
take	bring
surf	serf
pain	pane
pail	pale
normal	average median
track	tracked tract
baize	bays
incidence	incidents
tract	track tracked
pair	pare pear
mettle	medal meddle metal
gyro	giro
average	median normal
adopt	adapt adept
sale	sail
pores	pause paws pours
incite	insight
inequity	iniquity
cheap	cheep
mince	mints
fifty	50
shoe	shoo
shoo	shoe
slow	sloe
stair	stare
gourd	gored
plumb	plum
staid	stayed
sloe	slow
wood	would
incredulous	incredible
interstate	intrastate
bittern	bitten
cannon	canon
counsel	council
dye	die
gel	jell
median	average normal
pascal	paschal
morning	mourning
liable	libel
through	threw
aerie	airy eerie
where	ware wear
auricle	oracle
kernel	colonel
seas	sees seize
sear	seer sere
spore	spoor
seam	seem
hoes	hose
calendar	calender
palette	palate pallet
mutton	mouton
review	revue
paschal	pascal
gage	gauge
3	three
chews	choose
foreword	forward
style	stile sty
tacit	tacet
adept	adapt adopt
tun	ton
millinery	millinary
residence	residents
berry	bury
key	quay
quean	queen
terse	terce
sixty-six	66
jeans	genes
rheum	room
61	sixty-one
62	sixty-two
63	sixty-three
64	sixty-four
65	sixty-five
66	sixty-six
67	sixty-seven
68	sixty-eight
69	sixty-nine
bizarre	bazaar
poll	paul pole pull
mare	mayor
mark	marque
gist	jest
primmer	primer
extant	extent
eighty-three	83
sauce	source
mouton	mutton
shanty	chantey
cast	caste
eave	eve
strait	straight
greave	grieve
pax	packs
confidant	confident
lava	larva
epoch	epic
sucker	succour
isle	aisle i'll
mane	main
week	weak
ween	wean
weed	we'd
cymbal	cymbol symbol
lute	loot
eerie	aerie airy
eighty-five	85
poplar	popular
sixty-one	61
seventy-two	72
wale	wail whale
rest	rust wrest
kill	kiln
disperse	disburse
kiln	kill
sixteen	16
rose	rouse rows
except	accept
pallet	palate palette
allude	elude
bloc	block
4	for fore forth four fourth
tuff	tough
real	reel
larva	lava
read	red reed
tocsin	toxin
grid	grade grate great
world	whirled
fryer	friar
60	sixty
towed	toad toed
pole	paul poll pull
leek	leak
either	each
friar	fryer
cymbol	cymbal symbol
stationary	stationery
twelve	12
boar	bore
ascent	assent
dyeing	dying
seaman	semen
tuba	tuber
moor	maw more
seine	sane
throe	throw
voracious	veracious
sixty	60
bazaar	bizarre
throw	throe
oh	awe oar or ore owe
roar	raw
od	odd
knave	nave
doze	does
or	awe oar oh ore owe
road	rode rowed
rued	rood rude
eighty-seven	87
wade	weighed
your	yaw yore you''re you're
stare	stair
hew	hue
trussed	trust
there	their they're
loo	lieu
desert	dessert
low	lo
lox	locks
viscous	vicious viscus
leach	leech
gibe	jibe
groan	grown
lane	lain
burro	borough burrow
rouse	rose rows
sanitorium	sanitarium
pull	paul pole poll
hire	higher
preys	praise prays
bouillon	bullion
rust	rest wrest
intents	intense
palate	palette pallet
ad	add at
deer	dear
an	and end
bootie	booty
lichen	liken
tasty	tasteful
at	ad add
file	phial
creak	creek
personnel	personal
fifty-five	55
5	five
you	ewe yew
jell	gel
poor	pore pour
symbol	cymbal cymbol
pear	pair pare
peal	peel
poof	pouffe
peak	peek peke pique
ferrule	ferule
trusty	trustee
mask	masque
cored	chord cord
mast	massed
overseas	oversees
oral	aural
presentment	presentiment
caste	cast
retch	wretch
all	awl
liar	lyre
vile	vial viol
fifty-one	51
ale	ail
neigh	nay
pique	peak peek peke
reluctant	reticent
eighty-four	84
to	2 toe too tow two
tail	tale
te	tea tee
fax	facts
fay	fey
far	fah
eyrie	eery
soled	sold
roe	rho row
fah	far
worst	wurst
sane	seine
alms	arms
peon	paean
i'll	aisle isle
ten	10
tea	te tee
tee	te tea
past	passed
rate	right rite wright write
perspective	prospective
canvass	canvas
what	watt
sun	son
sum	some
eminent	imminent
judicious	judicial
vale	veil
mule	mewl
toed	toad towed
excess	access
divisor	deviser
whine	wine
base	bass
sealing	ceiling
raze	raise rays
pica	pika
attendance	attendants
eye	aye i
proceed	precede
faint	feint
two	2 to toe too tow
pearl	purl
tacks	tax
morn	mourn
6	six
minor	miner mynah
more	maw moor
flaw	floor
teem	team
knows	nose
materiel	marry material merry
canon	cannon
grisly	grizzly
mowed	mode
nineteen	19
grill	grille
none	nun
hour	our
dew	do due
mall	maul
nine	9
taut	taught tort
male	mail
gallop	galop
accept	except
stationery	stationary
hypercritical	hypocritical
phrase	frays
lacks	lax
axis	axes
court	caught
imminent	eminent
rye	wry
stayed	staid
ninety-eight	98
rude	rood rued
petite	petit petty
advice	advise
plane	plain
thirty-seven	37
seventy-one	71
twenty-nine	29
chute	shoot
register	registrar
caul	call
coal	kohl
plaice	place
torturous	tortuous
mousse	moose
dough	doe doh
pane	pain
turbine	turban
its	it's
24	twenty-four
25	twenty-five
26	twenty-six
27	twenty-seven
20	twenty
21	twenty-one
22	twenty-two
23	twenty-three
pray	prey
fined	find
glazier	glacier
28	twenty-eight
29	twenty-nine
braise	brays braze
might	mite
alter	altar
ally	alley
wry	rye
forbear	forebear
propose	purpose
reticent	reluctant
teas	tease
fairy	ferry
weight	wait
hare	hair
ball	bawl
wurst	worst
talisman	talesman
callus	callous
hart	heart
mustered	mustard
flower	flour
missed	mist
throes	throws
7	seven
bale	bail
viol	vial vile
bass	base
story	storey
heroin	heroine
put	putt
swot	swat
thrown	throne
prophet	profit
sheikh	shake
fifty-four	54
wither	whither
throws	throes
feet	feat fete
done	dun
mist	missed
moan	mown
horse	hoarse
guest	guessed
twenty	20
least	leased
stork	stalk
passed	past
sward	soared sword
moat	mote
too	2 to toe tow two
attendants	attendance
pare	pair pear
rifle	riffle
stairs	stares
oscillate	osculate
vial	vile viol
stalk	stork
sty	stile style
sell	cell
lie	lye
rowed	road rode
build	billed
populous	populace
hurtle	hurdle
gild	guild
77	seventy-seven
76	seventy-six
75	seventy-five
74	seventy-four
73	seventy-three
72	seventy-two
71	seventy-one
70	seventy
gilt	guilt
soared	sward sword
78	seventy-eight
yews	ewes use
seize	seas sees
barred	bard
fifty-two	52
barren	baron
weigh	way whey
tuber	tuba
sheik	chic
booze	boos
session	cession
find	fined
cell	sell
ruin	rune
8	ate eight
boulder	bolder
banned	band
him	hymn
forty-five	45
laager	lager
ninety-two	92
weaver	weever
wrote	rote
sew	saw so soar sore sow
seventeen	17
see	sea
arc	ark
bare	bear
bard	barred
sea	see
close	clothes cloze
bark	barque
ark	arc
wheald	wheeled
please	pleas
won	1 one
kneed	knead need
woe	whoa
rite	rate right wright write
who''s	who's whose
compliment	complement
sold	soled
sole	sol soul
license	licence
lase	laze
witch	which
whole	hole
load	lode
bell	bel belle
liken	lichen
sweet	suit suite
loan	lone
sine	sign
raise	rays raze
dun	done
create	crate
satire	satyr
due	dew do
damn	dam
coarse	course
pi	pie
twenty-eight	28
packs	pax
torque	talk
great	grade grate grid
grille	grill
bight	bite byte
vane	vain vein
wheeled	wheald
pact	packed
fur	fir
judicial	judicious
straight	strait
while	wile
loot	lute
loop	loupe
owed	ode
waul	wall
mote	moat
metre	meter
forebear	forbear
calender	calendar
virtu	virtue
hoar	haw whore
cygnet	signet
ewe	yew you
baste	based
pouffe	poof
9	nine
advise	advice
prerequisite	perquisite
higher	hire
mews	muse
censure	censer censor sensor
purpose	propose
residents	residence
perquisite	prerequisite
halve	have
eighty-nine	89
riffle	rifle
coup	coo
chord	cord cored
twenty-six	26
marque	mark
paten	patten pattern
prince	prints
carat	carrot
source	sauce
cue	kyu queue
eery	eyrie
bridal	bridle
steppe	step
ruff	rough
jibe	gibe
knock	nock
flue	flew flu
forty-four	44
eek	eke
sleigh	slay
ninety-four	94
ecology	environment
humorous	humerus
magnificent	munificent
yolk	yoke
sighs	size
martian	marten martin
sword	soared sward
pall	pawl
sight	cite site
pale	pail
seller	cellar
wares	wears
pee	pea
osculate	oscillate
epic	epoch
pea	pee
nose	knows
seventy-eight	78
hypocritical	hypercritical
weir	we're
rue	roo roux
step	steppe
carol	carrel
intense	intents
tortuous	torturous
bridle	bridal
block	bloc
rho	roe row
lessor	lesser
watt	what
clack	claque
lesson	lessen
sashay	sachet
rows	rose rouse
seventy-nine	79
lone	loan
lode	load
79	seventy-nine
suit	suite sweet
spar	spa
bored	board
reed	read red
reek	wreak
reel	real
skull	scull
up	upped
jalousie	jealousy
metal	medal meddle mettle
lye	lie
curb	kerb
valance	valence
talesman	talisman
peace	piece
tare	tear tier
fifty-nine	59
naw	gnaw nor
nay	neigh
nice	gneiss
cellar	seller
mustard	mustered
thirty-two	32
gallipot	galipot
fisher	fissure
hansom	handsome
heroine	heroin
ninety-one	91
mantel	mantle
holey	holy wholly
vice	vise
oracle	auricle
essay	assay
lean	lien
furze	furs
baron	barren
byre	buyer
breach	breech
sent	cent scent
assay	essay
dessert	desert
spoor	spore
wave	waive
llama	lama
iniquity	inequity
knight	night
marry	material materiel merry
eve	eave
supine	prone
frays	phrase
hairier	harrier
rack	wrack
pleas	please
booty	bootie
caw	core corps
fold	foaled
odd	od
ode	owed
colonel	kernel
access	excess
capital	capitol
coign	coin
lea	lee
led	lead
lee	lea
lei	lay ley
prescribe	proscribe
brooch	broach
sink	synch
licence	license
ley	lay lei
mewl	mule
fifteen	15
39	thirty-nine
38	thirty-eight
33	thirty-three
32	thirty-two
31	thirty-one
30	thirty
37	thirty-seven
36	thirty-six
35	thirty-five
34	thirty-four
oversees	overseas
mussel	muscle muzzle
climb	clime
gene	jean
clime	climb
wig	whig
chaste	chased
manna	manner manor
thirty-one	31
wit	whit
use	ewes yews
links	lynx
fifty-three	53
eleven	11
fey	fay
sort	sought
formally	formerly
tax	tacks
heir	air ere
missile	missal
sore	saw sew so soar sow
you''re	yaw yore you're your
rabbit	rabbet
billed	build
heard	herd
lapse	laps
tease	teas
pour	poor pore
praise	prays preys
meet	meat mete
peke	peak peek pique
pawl	pall
sanitarium	sanitorium
pawn	porn
plate	plait
rode	road rowed
rapt	rap rapped wrap wrapped
high	hi
villain	villein
carrot	carat
spa	spar
sought	sort
serial	cereal
paws	pause pores pours
hangar	hanger
lamb	lam
lama	llama
pure	peer pier
six	6
claque	clack
sic	sick
fete	feat feet
fare	fair
tact	tacked
tied	tide
tier	tare tear
prostate	prostrate
physic	physique psychic
prays	praise preys
summery	summary
insight	incite
meter	metre
sixty-nine	69
cruise	crews
write	rate right rite wright
brood	brewed
lo	low
guerrilla	gorilla guerilla
choose	chews
turban	turbine
bye	buy by
massed	mast
flex	flecks
fourth	4 for fore forth four
bolder	boulder
dam	damn
practice	practise
flew	flu flue
flea	flee
flee	flea
whither	wither
mode	mowed
thirty-eight	38
nye	nigh
tray	trey
veracious	voracious
flair	flare
tents	tense
88	eighty-eight
89	eighty-nine
thirteen	13
mete	meat meet
82	eighty-two
our	hour
80	eighty
81	eighty-one
86	eighty-six
87	eighty-seven
84	eighty-four
85	eighty-five
semen	seaman
populace	populous
wholly	holey holy
borne	born
red	read reed
troop	troupe
franc	frank
perish	parish
pours	pause paws pores
frank	franc
undo	undue
fourteen	14
graze	greys
tulle	tool
chilli	chile chili chilly
hostile	hostel
route	root
illicit	elicit
registrar	register
one hundred	100
prospective	perspective
tacked	tact
seventy-six	76
savour	saver
scene	seen
sack	sac
hey	hay
whoop	hoop
hurdle	hurtle
scent	cent sent
you're	yaw yore you''re your
laps	lapse
chased	chaste
their	there they're
wrapped	rap rapped rapt wrap
liquor	licker
prone	supine
sachet	sashay
feint	faint
steel	steal
aught	ought
bel	bell belle
bee	be
patients	patience
bey	bay
ferule	ferrule
gays	gaze
gambol	gamble
are	r
ingenious	ingenuous
fowl	foul
faun	fawn
tide	tied
have	halve
need	knead kneed
border	boarder
rotor	rota
loupe	loop
mil	mill
roux	roo rue
bough	beau bow
physique	physic psychic
apprise	appraise
which	witch
cozen	cousin
soar	saw sew so sore sow
tapir	taper
manor	manna manner
awl	all
eight	8 ate
vise	vice
peek	peak peke pique
gait	gate
medal	meddle metal mettle
urn	earn
bred	bread
you'll	yule
crate	create
sixty-two	62
bring	take
bier	beer
rough	ruff
feat	feet fete
marital	marshal marshall martial
principal	principle
one	1 won
pause	paws pores pours
based	baste
tire	tyre
wreak	reek
brayed	braid
jam	jamb
handsome	hansom
prosecute	persecute
they're	their there
beat	beet
beau	bough bow
leased	least
bear	bare
bean	been
buyer	byre
wring	ring
mynah	miner minor
rein	rain reign
allusion	illusion
freeze	frieze
desperate	disparate
greece	grease
packed	pact
mien	mean
pattern	paten patten
broach	brooch
genius	genus
tyre	tire
complement	compliment
mown	moan
no	know
merry	marry material materiel
roil	royal
weever	weaver
wear	ware where
sixty-three	63
wall	waul
indict	indite
satyr	satire
tort	taught taut
it's	its
yaw	yore you''re you're your
cent	scent sent
literal	littoral
gaze	gays
waste	waist
censor	censer censure sensor
eighty-one	81
caddy	caddie
tense	tents
mannequin	manikin
axle	axel
plain	plane
rigger	rigor
munificent	magnificent
plait	plate
wile	while
maul	mall
ninety-six	96
taupe	tope
dissent	descent
site	cite sight
weighed	wade
dual	duel
whorl	whirl
ninety-five	95
whore	haw hoar
whirl	whorl
chants	chance
flour	flower
whirr	were
phi	fie
material	marry materiel merry
proscribe	prescribe
bald	bawled
breech	breach
pedal	peddle
whale	wail wale
poultry	paltry
forty-eight	48
i	aye eye
49	forty-nine
muscle	mussel muzzle
45	forty-five
storey	story
twenty-three	23
paul	pole poll pull
wether	weather whether
wee	we whee
nicks	nix
add	ad at
wet	whet
practise	practice
ought	aught
knob	nob
canter	cantor
frieze	freeze
who's	who''s whose
haul	hall
five	5
know	no
knot	not
tick	tic
pier	peer pure
deviser	divisor
pries	prize
rabbet	rabbit
heed	he'd
martin	marten martian
rota	rotor
pried	pride
rote	wrote
heel	he'll heal
lager	laager
exceed	accede
guaranty	guarantee
sleight	slight
hail	hale
hair	hare
lead	led
leak	leek
viscus	vicious viscous
miner	minor mynah
shone	shown
does	doze
mined	mind
hose	hoes
slight	sleight
forty-seven	47
ninety-three	93
thirty-six	36
mite	might
paste	paced
whacks	wax
throne	thrown
pika	pica
surge	serge
owe	awe oar oh or ore
weather	wether whether
maize	maze
aweigh	away
maze	maize
buy	by bye
bur	burr
masque	mask
but	butt
forward	foreword
wight	white
hi	high
ho	hoe
grate	grade great grid
be	bee
paean	peon
made	maid
whether	weather wether
official	officious
grieve	greave
whoa	woe
cruel	crewel
leech	leach
lynx	links
piece	peace
signet	cygnet
appraise	apprise
thirty-nine	39
pie	pi
inn	in
83	eighty-three
48	forty-eight
incredible	incredulous
46	forty-six
47	forty-seven
44	forty-four
boos	booze
42	forty-two
43	forty-three
40	forty
41	forty-one
burrow	borough burro
oar	awe oh or ore owe
sick	sic
illusion	allusion
quartz	quarts
draught	draft
quarts	quartz
shown	shone
chance	chants
cheque	check
veil	vale
vein	vain vane
jewel	joule
depravation	deprivation
we're	weir
buoy	boy
