chaperones	chaperonas
faveadores	faveadoras
troleadores	troleadoras
tuiteadores	tuiteadoras
tacobeleros	tacobeleras
raqueteros	raqueteras
landsquiperos	landsquiperas
ruferos	ruferas
traileros	traileras
aiscrineros	aiscrineras
califeños	califeñas
californios	californias
baristas	baristas
barténderes	barténderes
bartenders	bartenders
taipistas	taipistas
watchmen	watchmen
rookies	rookies
cleaners	cleaners
soloístas	soloístas
droguistas	droguistas
phishers	phishers
desperados	desperados
teens	teens
teenagers	teenagers
mánagers	mánagers
managers	managers
chirlíders	chirlíders
cheerleaders	cheerleaders
jandimanes	jandimanes
handymen	handymen
jánitores	jánitores
janitores	janitores
yánitores	yánitores
lánlores	lánlores
landlords	landlords
producers	producers
rangers	rangers
hostes	hostes
coaches	coaches
bosses	bosses
áncormanes	áncormanes
podiatras	podiatras
