tipos	tipas
tipazos	tipazas
presidentes	presidentas
ejecutivos	ejecutivas
negociantes	negociantas
hijos	hijas
hijitos	hijitas
mijos	mijas
mijitos	mijitas
intendentes	intendentas
viceintendentes	viceintendentas
manicuros	manicuras
doctorcitos	doctorcitas
mayorcitos	mayorcitas
nuevecitos	nuevecitas
exponedores	exponedoras
arbitradores	arbitradoras
criticones	criticonas
criticastros	criticastras
criticadores	criticadoras
figurantes	figurantas
muertos	muertas
dormidos	dormidas
atentos	atentas
disciplinarios	disciplinarias
disciplinados	disciplinadas
depositadores	depositadoras
adoptadores	adoptadoras
usuarios	usuarias
conocidos	conocidas
amigos	amigas
amiguitos	amiguitas
reyes	reinas
virreyes	virreinas
zares	zarinas
papas	papisas
zagales	zagalas
eclesiásticos	eclesiásticas
provicarios	provicarias
vicarios	vicarias
infiltrados	infiltradas
penitentes	penitentas
espadachines	espadachinas
eugenésicos	eugenésicas
regentes	regentas
pretendientes	pretendientas
concertinos	concertinas
farsantes	farsantas
pajareros	pajareras
groseros	groseras
bedeles	bedelas
funámbulos	funámbulas
académicos	académicas
antipáticos	antipáticas
autoritarios	autoritarias
danzantes	danzantas
palabreros	palabreras
filántropos	filántropas
zoroástricos	zoroástricas
fernandinos	fernandinas
liantes	liantas
éticos	éticas
cronólogos	cronólogas
pedicuros	pedicuras
confederados	confederadas
antiacadémicos	antiacadémicas
anti-académicos	anti-académicas
bolivarianos	bolivarianas
micrográficos	micrográficas
humanos	humanas
favoritos	favoritas
malditos	malditas
individuos	individuas
clientes	clientas
exclientes	exclientas
exnovios	exnovias
ex-novios	ex-novias
jugadores	jugadoras
soldadores	soldadoras
jefes	jefas
escritores	escritoras
técnicos	técnicas
ministros	ministras
campeones	campeonas
viejos	viejas
viejecitos	viejecitas
darwinianos	darwinianas
físicos	físicas
dones	doñas
candidatos	candidatas
alcaldes	alcaldesas
enviados	enviadas
queridos	queridas
famosos	famosas
famosillos	famosillas
secretarios	secretarias
servidores	servidoras
científicos	científicas
navegadores	navegadoras
productores	productoras
enemigos	enemigas
propietarios	propietarias
capitanes	capitanas
editores	editoras
alumnos	alumnas
dueños	dueñas
encargados	encargadas
socios	socias
fundadores	fundadoras
europeos	europeas
diputados	diputadas
críticos	críticas
pintores	pintoras
patrones	patronas
lindos	lindas
conductores	conductoras
marítimos	marítimas
obispos	obispas
gatos	gatas
perros	perras
perritos	perritas
curiosos	curiosas
meticulosos	meticulosas
escrupulosos	escrupulosas
minuciosos	minuciosas
músicos	músicas
americanos	americanas
samoamericanos	samoamericanas
empresarios	empresarias
trabajadores	trabajadoras
locos	locas
detenidos	detenidas
condes	condesas
vecinos	vecinas
administradores	administradoras
expertos	expertas
delanteros	delanteras
creadores	creadoras
gigantes	gigantas
santos	santas
invitados	invitadas
desconocidos	desconocidas
latinos	latinas
funcionarios	funcionarias
jurados	juradas
consumidores	consumidoras
vicepresidentes	vicepresidentas
acusados	acusadas
desaparecidos	desaparecidas
externos	externas
investigadores	investigadoras
mantenidos	mantenidas
lógicos	lógicas
teutones	teutonas
sucesores	sucesoras
condenados	condenadas
papás	mamás
universitarios	universitarias
enfermos	enfermas
casados	casadas
gerentes	gerentas
subgerentes	subgerentas
exgerentes	exgerentas
fotógrafos	fotógrafas
revolucionarios	revolucionarias
animalísticos	animalísticas
senadores	senadoras
enamorados	enamoradas
embajadores	embajadoras
creativos	creativas
convencidos	convencidas
espectadores	espectadoras
defensores	defensoras
operadores	operadoras
asesores	asesoras
judíos	judías
vendedores	vendedoras
séptimos	séptimas
dependientes	dependientas
diablos	diablas
mandatarios	mandatarias
lobos	lobas
lobitos	lobitas
porteros	porteras
profetas	profetisas
corredores	corredoras
concejales	concejalas
monos	monas
derrotados	derrotadas
agregados	agregadas
sanitarios	sanitarias
pastores	pastoras
leones	leonas
colaboradores	colaboradoras
protectores	protectoras
químicos	químicas
adoptados	adoptadas
monitores	monitoras
republicanos	republicanas
moderados	moderadas
mecánicos	mecánicas
herederos	herederas
aficionados	aficionadas
rectores	rectoras
tontos	tontas
tontitos	tontitas
tramposos	tramposas
traicioneros	traicioneras
embusteros	embusteras
nietos	nietas
nietitos	nietitas
holandeses	holandesas
domésticos	domésticas
ciegos	ciegas
informáticos	informáticas
viajeros	viajeras
matemáticos	matemáticas
ancianos	ancianas
goleadores	goleadoras
ferroviarios	ferroviarias
sabios	sabias
controladores	controladoras
conservadores	conservadoras
dragones	dragonas
innovadores	innovadoras
anónimos	anónimas
obreros	obreras
flamencos	flamencas
narradores	narradoras
compradores	compradoras
guerreros	guerreras
gallegos	gallegas
voluntarios	voluntarias
dictadores	dictadoras
parlamentarios	parlamentarias
gordos	gordas
bibliotecarios	bibliotecarias
predecesores	predecesoras
gestores	gestoras
vampiros	vampiras
homónimos	homónimas
directivos	directivas
veteranos	veteranas
valencianos	valencianas
ladrones	ladronas
nativos	nativas
luchadores	luchadoras
presentadores	presentadoras
pioneros	pioneras
catedráticos	catedráticas
bancarios	bancarias
arqueros	arqueras
discípulos	discípulas
conejos	conejas
conejitos	conejitas
sospechosos	sospechosas
emprendedores	emprendedoras
esclavos	esclavas
espabilados	espabiladas
pícaros	pícaras
tunantes	tunantas
vencedores	vencedoras
exploradores	exploradoras
promotores	promotoras
contadores	contadoras
cazadores	cazadoras
distribuidores	distribuidoras
organizadores	organizadoras
legisladores	legisladoras
cirujanos	cirujanas
publicitarios	publicitarias
observadores	observadoras
comisarios	comisarias
pasajeros	pasajeras
opositores	opositoras
tutores	tutoras
primitivos	primitivas
millonarios	millonarias
dramaturgos	dramaturgas
seguidores	seguidoras
reguladores	reguladoras
magistrados	magistradas
empleadores	empleadoras
corderos	corderas
veterinarios	veterinarias
criados	criadas
redactores	redactoras
cantautores	cantautoras
portadores	portadoras
adversarios	adversarias
rubios	rubias
amorosos	amorosas
campesinos	campesinas
didácticos	didácticas
partidarios	partidarias
asturianos	asturianas
interinos	interinas
inventores	inventoras
toreros	toreras
estadísticos	estadísticas
pavos	pavas
deudores	deudoras
inspectores	inspectoras
desarrolladores	desarrolladoras
cuñados	cuñadas
infantes	infantas
astrónomos	astrónomas
tenedores	tenedoras
párrocos	párrocas
ibéricos	ibéricas
instructores	instructoras
mudos	mudas
borrachos	borrachas
consultores	consultoras
parientes	parientas
solteros	solteras
corruptos	corruptas
destinatarios	destinatarias
canarios	canarias
reporteros	reporteras
inversores	inversoras
emotivos	emotivas
serbios	serbias
estúpidos	estúpidas
payasos	payasas
constructores	constructoras
palestinos	palestinas
mojados	mojadas
precursores	precursoras
fracasados	fracasadas
guardianes	guardianas
enanos	enanas
acreedores	acreedoras
bizantinos	bizantinas
rústicos	rústicas
fanáticos	fanáticas
unitarios	unitarias
mensajeros	mensajeras
burros	burras
afiliados	afiliadas
ilustradores	ilustradoras
lanzadores	lanzadoras
graduados	graduadas
sudamericanos	sudamericanas
morenos	morenas
morenitos	morenitas
zorros	zorras
zorritos	zorritas
locutores	locutoras
antecesores	antecesoras
demandados	demandadas
raperos	raperas
procuradores	procuradoras
decanos	decanas
supervisores	supervisoras
místicos	místicas
mentores	mentoras
cachorros	cachorras
cachorritos	cachorritas
padrinos	madrinas
pescadores	pescadoras
notarios	notarias
subsecretarios	subsecretarias
beneficiarios	beneficiarias
siervos	siervas
marineros	marineras
salvadores	salvadoras
competidores	competidoras
sevillanos	sevillanas
patrocinadores	patrocinadoras
guerrilleros	guerrilleras
romeros	romeras
vagos	vagas
tiranos	tiranas
adictos	adictas
egresados	egresadas
patriarcas	matriarcas
carpinteros	carpinteras
seleccionadores	seleccionadoras
intermediarios	intermediarias
artesanos	artesanas
interlocutores	interlocutoras
mediadores	mediadoras
puertorriqueños	puertorriqueñas
andromedanos	andromedanas
conquistadores	conquistadoras
regidores	regidoras
correctores	correctoras
oradores	oradoras
cajeros	cajeras
exiliados	exiliadas
yernos	nueras
vigésimos	vigésimas
apoderados	apoderadas
jardineros	jardineras
burgueses	burguesas
ganaderos	ganaderas
pensadores	pensadoras
psíquicos	psíquicas
flacos	flacas
flaquitos	flaquitas
prematuros	prematuras
anotadores	anotadoras
noticieros	noticieras
navarros	navarras
agricultores	agricultoras
exportadores	exportadoras
tiradores	tiradoras
neoclásicos	neoclásicas
perdedores	perdedoras
colectores	colectoras
honorarios	honorarias
transmisores	transmisoras
ingenuos	ingenuas
murciélagos	murciélagas
eruditos	eruditas
destructores	destructoras
cofundadores	cofundadoras
ticos	ticas
jubilados	jubiladas
animadores	animadoras
cabrones	cabronas
clandestinos	clandestinas
peregrinos	peregrinas
instaladores	instaladoras
oriundos	oriundas
prefectos	prefectas
estudiosos	estudiosas
loros	loras
preparadores	preparadoras
auditores	auditoras
huérfanos	huérfanas
peones	peonas
sordos	sordas
laicos	laicas
tapados	tapadas
admiradores	admiradoras
limpiadores	limpiadoras
colorados	coloradas
multimillonarios	multimillonarias
refugiados	refugiadas
gatitos	gatitas
emuladores	emuladoras
subdirectores	subdirectoras
tesoreros	tesoreras
depredadores	depredadoras
progenitores	progenitoras
inquilinos	inquilinas
homólogos	homólogas
bárbaros	bárbaras
predicadores	predicadoras
sapos	sapas
coautores	coautoras
virtuosos	virtuosas
alcohólicos	alcohólicas
seductores	seductoras
escépticos	escépticas
comunicadores	comunicadoras
viceministros	viceministras
calvos	calvas
franciscanos	franciscanas
pillos	pillas
serranos	serranas
devotos	devotas
cantores	cantoras
paisanos	paisanas
diplomados	diplomadas
galeses	galesas
papis	mamis
papitos	mamitas
papacitos	mamacitas
topos	topas
antepasados	antepasadas
peritos	peritas
hoteleros	hoteleras
pendejos	pendejas
subordinados	subordinadas
rockeros	rockeras
mafiosos	mafiosas
letrados	letradas
desgraciados	desgraciadas
barceloneses	barcelonesas
recibidores	recibidoras
cuidadores	cuidadoras
rabinos	rabinas
vizcondes	vizcondesas
malagueños	malagueñas
francotiradores	francotiradoras
electores	electoras
exjugadores	exjugadoras
llaveros	llaveras
cautivos	cautivas
pelados	peladas
mendigos	mendigas
leoneses	leonesas
tigres	tigresas
extremeños	extremeñas
bomberos	bomberas
occitanos	occitanas
escribanos	escribanas
chiquitos	chiquitas
chiquititos	chiquititas
pequeñines	pequeñinas
chivos	chivas
libertarios	libertarias
camellos	camellas
vagabundos	vagabundas
aseguradores	aseguradoras
soñadores	soñadoras
operarios	operarias
paganos	paganas
mercenarios	mercenarias
inhibidores	inhibidoras
alpinos	alpinas
visionarios	visionarias
convertidores	convertidoras
vikingos	vikingas
cínicos	cínicas
tibetanos	tibetanas
ginecólogos	ginecólogas
ancestros	ancestras
centroamericanos	centroamericanas
mestizos	mestizas
formadores	formadoras
labradores	labradoras
matadores	matadoras
enfermeros	enfermeras
vegetarianos	vegetarianas
becarios	becarias
ositos	ositas
osos	osas
patitos	patitas
patos	patas
cerdos	cerdas
cerditos	cerditas
expositores	expositoras
geógrafos	geógrafas
precandidatos	precandidatas
manipuladores	manipuladoras
curadores	curadoras
infractores	infractoras
geólogos	geólogas
carteros	carteras
propulsores	propulsoras
mezcladores	mezcladoras
pedagogos	pedagogas
triunfadores	triunfadoras
facilitadores	facilitadoras
importadores	importadoras
bastardos	bastardas
transportadores	transportadoras
filólogos	filólogas
lexicográficos	lexicográficas
lexicológicos	lexicológicas
arrendatarios	arrendatarias
sureños	sureñas
panaderos	panaderas
violadores	violadoras
prelados	preladas
consoladores	consoladoras
reductores	reductoras
coreógrafos	coreógrafas
metafísicos	metafísicas
entrevistadores	entrevistadoras
prófugos	prófugas
gringos	gringas
asnos	asnas
germanos	germanas
bisabuelos	bisabuelas
abuelitos	abuelitas
principitos	princesitas
eclécticos	eclécticas
integradores	integradoras
manchegos	manchegas
hidalgos	hidalgas
fugitivos	fugitivas
priores	prioras
repartidores	repartidoras
coquetos	coquetas
homenajeados	homenajeadas
basureros	basureras
marcianos	marcianas
venusinos	venusinas
saturnianos	saturnianas
abridores	abridoras
negociadores	negociadoras
cinéfilos	cinéfilas
reparadores	reparadoras
interventores	interventoras
arameos	arameas
disparadores	disparadoras
divorciados	divorciadas
dispersos	dispersas
platónicos	platónicas
emigrados	emigradas
norteños	norteñas
gaditanos	gaditanas
intrusos	intrusas
peatones	peatonas
profanos	profanas
barberos	barberas
libertadores	libertadoras
hermanastros	hermanastras
pervertidos	pervertidas
confesores	confesoras
astrólogos	astrólogas
provocadores	provocadoras
marginados	marginadas
piscos	piscas
superintendentes	superintendentas
corsos	corsas
camioneros	camioneras
prusianos	prusianas
estafadores	estafadoras
multiplicadores	multiplicadoras
archiduques	archiduquesas
bandidos	bandidas
bloqueadores	bloqueadoras
relatores	relatoras
riojanos	riojanas
cantaores	cantaoras
bateadores	bateadoras
potros	potras
analizadores	analizadoras
beatos	beatas
postores	postoras
politólogos	politólogas
obesos	obesas
californianos	californianas
benefactores	benefactoras
vicegobernadores	vicegobernadoras
ex-presidentes	ex-presidentas
expresidentes	expresidentas
copresidentes	copresidentas
gansos	gansas
paleontólogos	paleontólogas
acumuladores	acumuladoras
perseguidores	perseguidoras
cornudos	cornudas
usurpadores	usurpadoras
liberadores	liberadoras
forasteros	forasteras
discapacitados	discapacitadas
bretones	bretonas
sicarios	sicarias
escandinavos	escandinavas
lusos	lusas
perturbadores	perturbadoras
secuestradores	secuestradoras
fulanos	fulanas
síndicos	síndicas
peloteros	peloteras
joyeros	joyeras
acomodados	acomodadas
hacendados	hacendadas
emisarios	emisarias
matones	matonas
orientadores	orientadoras
agrónomos	agrónomas
literatos	literatas
arrendadores	arrendadoras
desempleados	desempleadas
inquisidores	inquisidoras
comendadores	comendadoras
roperos	roperas
benedictinos	benedictinas
dermatólogos	dermatólogas
bioquímicos	bioquímicas
canteranos	canteranas
cortesanos	cortesanas
ideólogos	ideólogas
conselleres	conselleras
registradores	registradoras
llaneros	llaneras
redentores	redentoras
cabritos	cabritas
bisnietos	bisnietas
tuertos	tuertas
florentinos	florentinas
corsarios	corsarias
pupilos	pupilas
musicólogos	musicólogas
kurdos	kurdas
conciliadores	conciliadoras
impostores	impostoras
chiquillos	chiquillas
repetidores	repetidoras
suburbanos	suburbanas
contralores	contraloras
recolectores	recolectoras
imitadores	imitadoras
analfabetos	analfabetas
suscriptores	suscriptoras
probadores	probadoras
inexpertos	inexpertas
napolitanos	napolitanas
armadores	armadoras
iberoamericanos	iberoamericanas
sicilianos	sicilianas
reformadores	reformadoras
proletarios	proletarias
genoveses	genovesas
retrógrados	retrógradas
vicerrectores	vicerrectoras
planificadores	planificadoras
hacedores	hacedoras
espartanos	espartanas
novilleros	novilleras
chanchos	chanchas
zaragozanos	zaragozanas
fenicios	fenicias
hispanoamericanos	hispanoamericanas
bicampeones	bicampeonas
salmantinos	salmantinas
conversos	conversas
eurodiputados	eurodiputadas
bávaros	bávaras
cerveceros	cerveceras
gladiadores	gladiadoras
agraciados	agraciadas
esquiadores	esquiadoras
pobrecitos	pobrecitas
búfalos	búfalas
suramericanos	suramericanas
maltratadores	maltratadoras
insensatos	insensatas
sensatos	sensatas
drogadictos	drogadictas
becados	becadas
lecheros	lecheras
tomadores	tomadoras
charros	charras
metalúrgicos	metalúrgicas
metaleros	metaleras
calculadores	calculadoras
criadores	criadoras
manufactureros	manufactureras
incomprendidos	incomprendidas
convictos	convictas
cartagineses	cartaginesas
tarados	taradas
meseros	meseras
mulatos	mulatas
avaros	avaras
cartógrafos	cartógrafas
introvertidos	introvertidas
abusadores	abusadoras
activadores	activadoras
decoradores	decoradoras
surtidores	surtidoras
examinadores	examinadoras
testadores	testadoras
asirios	asirias
visitadores	visitadoras
prestatarios	prestatarias
mejicanos	mejicanas
montañeros	montañeras
anunciadores	anunciadoras
remolcadores	remolcadoras
toscanos	toscanas
subalternos	subalternas
recaudadores	recaudadoras
vengadores	vengadoras
finados	finadas
futboleros	futboleras
vicesecretarios	vicesecretarias
hipopótamos	hipopótamas
paralíticos	paralíticas
bebedores	bebedoras
ochentenos	ochentenas
escenógrafos	escenógrafas
xenófobos	xenófobas
cabezones	cabezonas
normandos	normandas
drogados	drogadas
siberianos	siberianas
hawaianos	hawaianas
exsecretarios	exsecretarias
chatos	chatas
reclusos	reclusas
agnósticos	agnósticas
ingratos	ingratas
pijos	pijas
borregos	borregas
desertores	desertoras
jornaleros	jornaleras
benjamines	benjaminas
transgresores	transgresoras
codirectores	codirectoras
salseros	salseras
sádicos	sádicas
chiflados	chifladas
trepadores	trepadoras
desalojados	desalojadas
micólogos	micólogas
fiadores	fiadoras
presumidos	presumidas
continuadores	continuadoras
colonizadores	colonizadoras
bandoleros	bandoleras
desamparados	desamparadas
dadores	dadoras
preceptores	preceptoras
oidores	oidoras
lombardos	lombardas
neuróticos	neuróticas
hospedadores	hospedadoras
leprosos	leprosas
súbditos	súbditas
pitufos	pitufas
meteorólogos	meteorólogas
sumerios	sumerias
titiriteros	titiriteras
filosofos	filosofas
jorobados	jorobadas
pasteleros	pasteleras
entomólogos	entomólogas
pedófilos	pedófilas
moriscos	moriscas
cholos	cholas
occisos	occisas
suministradores	suministradoras
esquizofrénicos	esquizofrénicas
explotadores	explotadoras
comuneros	comuneras
guarros	guarras
incendiarios	incendiarias
segovianos	segovianas
carceleros	carceleras
victimarios	victimarias
cobradores	cobradoras
patinadores	patinadoras
tejanos	tejanas
gamberros	gamberras
manejadores	manejadoras
colchoneros	colchoneras
histéricos	histéricas
llorones	lloronas
jónicos	jónicas
torturadores	torturadoras
anglicanos	anglicanas
rancheros	rancheras
checoslovacos	checoslovacas
samaritanos	samaritanas
visualizadores	visualizadoras
devoradores	devoradoras
templarios	templarias
rastreadores	rastreadoras
montadores	montadoras
andadores	andadoras
milicianos	milicianas
pobladores	pobladoras
clasificadores	clasificadoras
estimuladores	estimuladoras
salesianos	salesianas
libertinos	libertinas
gregarios	gregarias
pololos	pololas
indoeuropeos	indoeuropeas
euroasiáticos	euroasiáticas
eurasiáticos	eurasiáticas
telemáticos	telemáticas
plebeyos	plebeyas
urólogos	urólogas
lechones	lechonas
petardos	petardas
adeptos	adeptas
neurocirujanos	neurocirujanas
introductores	introductoras
fariseos	fariseas
evangelizadores	evangelizadoras
reboteadores	reboteadoras
trinitarios	trinitarias
superdotados	superdotadas
gruñones	gruñonas
ortopédicos	ortopédicas
cocheros	cocheras
tranquilizadores	tranquilizadoras
cretinos	cretinas
necios	necias
tercos	tercas
obstinados	obstinadas
testarudos	testarudas
oncólogos	oncólogas
encomenderos	encomenderas
coruñeses	coruñesas
neonatos	neonatas
molineros	molineras
mañaneros	mañaneras
cantoneses	cantonesas
mochileros	mochileras
exdiputados	exdiputadas
supervillanos	supervillanas
superhéroes	superheroínas
limoneros	limoneras
pichones	pichonas
enólogos	enólogas
lacayos	lacayas
mamones	mamonas
teloneros	teloneras
informadores	informadoras
arrieros	arrieras
mesoamericanos	mesoamericanas
boticarios	boticarias
cantábricos	cantábricas
picadores	picadoras
muchachitos	muchachitas
hombrecitos	mujercitas
maños	mañas
demagogos	demagogas
indianos	indianas
archiveros	archiveras
cuates	cuatas
instigadores	instigadoras
afinadores	afinadoras
barqueros	barqueras
apáticos	apáticas
depravados	depravadas
catetos	catetas
cancerberos	cancerberas
arios	arias
exterminadores	exterminadoras
texanos	texanas
patólogos	patólogas
tejedores	tejedoras
rectificadores	rectificadoras
agrimensores	agrimensoras
costeños	costeñas
retardados	retardadas
delatores	delatoras
acusadores	acusadoras
indocumentados	indocumentadas
documentados	documentadas
conspiradores	conspiradoras
excandidatos	excandidatas
celadores	celadoras
neófitos	neófitas
sorianos	sorianas
traumatólogos	traumatólogas
recuperadores	recuperadoras
tricampeones	tricampeonas
vividores	vividoras
peticionarios	peticionarias
valedores	valedoras
armeros	armeras
jurisconsultos	jurisconsultas
estimadores	estimadoras
mixtecos	mixtecas
milaneses	milanesas
pardillos	pardillas
ribereños	ribereñas
pirotécnicos	pirotécnicas
cosacos	cosacas
morosos	morosas
supresores	supresoras
especuladores	especuladoras
reclutadores	reclutadoras
jefazos	jefazas
posaderos	posaderas
blasfemos	blasfemas
tertulianos	tertulianas
maníacos	maníacas
fiscalizadores	fiscalizadoras
tatarabuelos	tatarabuelas
copropietarios	copropietarias
mellizos	mellizas
perpetradores	perpetradoras
freudianos	freudianas
donadores	donadoras
taquilleros	taquilleras
paramédicos	paramédicas
mormones	mormonas
bodegueros	bodegueras
maquilladores	maquilladoras
captores	captoras
novicios	novicias
rejoneadores	rejoneadoras
atracadores	atracadoras
dobladores	dobladoras
tipejos	tipejas
homofóbicos	homofóbicas
etnólogos	etnólogas
frigios	frigias
archivadores	archivadoras
substitutos	substitutas
malcriados	malcriadas
tecnólogos	tecnólogas
primerizos	primerizas
montenegrinos	montenegrinas
tatuadores	tatuadoras
mamarrachos	mamarrachas
octogenarios	octogenarias
puritanos	puritanas
egiptólogos	egiptólogas
aritméticos	aritméticas
carroceros	carroceras
lunáticos	lunáticas
tasadores	tasadoras
germanófobos	germanófonas
vascófilos	vascófilas
halterófilos	halterófilas
anglófilos	anglófilas
hispanófilos	hispanófilas
enófilos	enófilas
italianófilos	italianófilas
cervantófilos	cervantófilas
germanófilos	germanófilas
rusófilos	rusófilas
colombófilos	colombófilas
pánfilos	pánfilas
galófilos	galófilas
negrófilos	negrófilas
taurófilos	taurófilas
indiófilos	indiófilas
paidófilos	paidófilas
aliadófilos	aliadófilas
eurófilos	eurófilas
eurocríticos	eurocríticas
euroescépticos	euroescépticoas
eurófobos	eurófobos
tránsfobos	tránsfobas
islamófobos	islamófobas
rusófobos	rusófobas
anglófobos	anglófobas
hispanófobos	hispanófobas
francófobos	francófobas
galófobos	galófobas
clerófobos	clerófobas
andrófobos	andrófobas
taurófobos	taurófobas
aerófobos	aerófobas
homófobos	homófobas
fotófobos	fotófobas
exprofesores	exprofesoras
ex-profesores	ex-profesoras
excoordinadores	excoordinadoras
ex-coordinadores	ex-coordinadoras
exlegisladores	exlegisladoras
ex-legisladores	ex-legisladoras
exluchadores	exluchadoras
ex-luchadores	ex-luchadoras
expeloteros	expeloteras
exdecanos	exdecanas
exeditores	exeditoras
exadministradores	exadministradoras
exnadadores	exnadadoras
experimentadores	experimentadoras
exclaustrados	exclaustradas
expoliadores	expoliadoras
azafatos	azafatas
charlatanes	charlatanas
germanófonos	germanófonas
francófonos	francófonas
anglófonos	anglófonas
portugalujos	portugalujas
lisboneses	lisbonesas
cocinerazos	cocinerazas
cocinerasos	cocinerasas
juglares	juglaresas
guardeses	guardesas
salamanqueses	salamanquesas
pequeñoburgueses	pequeñoburguesas
conciudadanos	conciudadanas
institutores	institutrices
sastres	sastras
criollos	criollas
guapos	guapas
cabeceadores	cabeceadoras
embaladores	embaladoras
masones	masonas
despiertos	despiertas
lagartos	lagartas
elefantes	elefantas
venados	venadas
terneros	terneras
cochinos	cochinas
jabalíes	jabalinas
cabezudos	cabezudas
delgaduchos	delgaduchas
flacuchos	flacuchas
medicuchos	medicuchas
enfermuchos	enfermuchas
larguiruchos	larguiruchas
delicaduchos	delicaduchas
meones	meonas
fregones	fregonas
muchachones	muchachonas
matrones	matronas
sinvergonzones	sinvergonzonas
pendejones	pendejonas
pobretones	pobretonas
trentones	trentonas
cuarentones	cuarentonas
cincuentones	cincuentonas
ochentones	ochentonas
gritones	gritonas
gigantones	gigantonas
valentones	valentonas
gordinflones	gordinflonas
gordiflones	gordiflonas
bribones	bribonas
fanfarrones	fanfarronas
replicones	repliconas
poltrones	poltronas
chingones	chingonas
huevones	huevonas
mirones	mironas
chabones	chabonas
chambones	chambonas
soplones	soplonas
empollones	empollonas
bravucones	bravuconas
burlones	burlonas
zumbones	zumbonas
guasones	guasonas
vacilones	vacilonas
mandones	mandonas
tetracampeones	tetracampeonas
multicampeones	multicampeonas
excampeones	excampeonas
ex-campeones	ex-campeonas
ricachones	ricachonas
ricachos	ricachas
tontorrones	tontorronas
gorrones	gorronas
bobalicones	bobaliconas
buchones	buchonas
comilones	comilonas
comelones	comelonas
zampones	zamponas
tragones	tragonas
copiones	copionas
rajones	rajonas
santurrones	santurronas
barbones	barbonas
pechugones	pechugonas
remendones	remendonas
infanzones	infanzonas
beberrones	beberronas
borrachones	borrachonas
borrachines	borrachinas
borrachitos	borrachitas
borrachuzos	borrachuzas
respondones	respondonas
cuarterones	cuarteronas
grandulones	grandulonas
grandullones	grandullonas
simpaticones	simpaticonas
querendones	querendonas
señorones	señoronas
retozones	retozonas
lambones	lambonas
adulones	adulonas
fumones	fumonas
pachones	pachonas
barbudos	barbudas
bobos	bobas
bobitos	bobitas
dadivosos	dadivosas
suegros	suegras
suegritos	suegritas
cuñaditos	cuñaditas
bisabuelitos	bisabuelitas
bisnietitos	bisnietitas
biznietitos	biznietitas
jovencillos	jovencillas
jovencitos	jovencitas
bebecitos	bebecitas
bebitos	bebitas
cieguitos	cieguitas
fulanitos	fulanitas
sobrinitos	sobrinitas
vecinitos	vecinitas
huerfanitos	huerfanitas
payasitos	payasitas
jefecitos	jefecitas
maestritos	maestritas
compañeritos	compañeritas
burguesitos	burguesitas
negritos	negritas
blanquitos	blanquitas
soldaditos	soldaditas
concejalitos	concejalitas
enfermitos	enfermitas
pastorcitos	pastorcitas
loquitos	loquitas
dormiditos	dormiditas
nerviositos	nerviositas
ocupaditos	ocupaditas
gorditos	gorditas
viejitos	viejitas
ancianitos	ancianitas
chinitos	chinitas
rusitos	rusitas
cubanitos	cubanitas
chilenitos	chilenitas
polaquitos	polaquitas
inditos	inditas
indiecitos	indiecitas
españolitos	españolitas
galleguitos	galleguitas
vasquitos	vasquitas
inglesitos	inglesitas
francesitos	francesitas
gringuitos	gringuitas
vaqueritos	vaqueritas
noviecitos	noviecitas
solteritos	solteritas
papasitos	mamasitas
geniecitos	geniecitas
enanitos	enanitas
diablitos	diablitas
monstruitos	monstruitas
vampiritos	vampiritas
brujitos	brujitas
robotitos	robotitas
marcianitos	marcianitas
chavitos	chavitas
güeritos	güeritas
pelirrojitos	pelirrojitas
rubiecitos	rubiecitas
rubitos	rubitas
peluditos	peluditas
enamoraditos	enamoraditas
puerquitos	puerquitas
chanchitos	chanchitas
cochinitos	cochinitas
lechoncitos	lechoncitas
leoncitos	leoncitas
tigrecitos	tigrecitas
elefantitos	elefantitas
venaditos	venaditas
terneritos	terneritas
putitos	putitas
pendejitos	pendejitas
guapotes	guapotas
guapitos	guapitas
amigotes	amigotas
diablotes	diablotas
payasotes	payasotas
muchachotes	muchachotas
neoyorquinos	neoyorquinas
muñecos	muñecas
muñequitos	muñequitas
ladronzuelos	ladronzuelas
bribonzuelos	bribonzuelas
jovenzuelos	jovenzuelas
mozuelos	mozuelas
muchachuelos	muchachuelas
güeros	güeras
gueros	gueras
remeros	remeras
boludos	boludas
boluditos	boluditas
gaiteros	gaiteras
cumpleañeros	cumpleañeras
pandilleros	pandilleras
arequipeños	arequipeñas
trujillanos	trujillanas
talareños	talareñas
chiclayanos	chiclayanas
piuranos	piuranas
huaralinos	huaralinas
huancaínos	huancaínas
huancaneños	huancaneñas
huancavelicanos	huancavelicanas
chimbotanos	chimbotanas
pucallpinos	pucallpinas
pucallpeños	pucallpeñas
juliaqueños	juliaqueñas
ayacuchanos	ayacuchanas
pisqueños	pisqueñas
cajamarquinos	cajamarquinas
huanuqueños	huanuqueñas
punateños	punateñas
iquiteños	iquiteñas
lambayecanos	lambayecanas
huamanguinos	huamanguinas
chinchanos	chinchanas
loretanos	loretanas
cañetanos	cañetanas
sanromaneños	sanromaneñas
pasqueños	pasqueñas
tumbesinos	tumbesinas
chanchamayinos	chanchamayinas
chotanos	chotanas
ucayalinos	ucayalinas
ancashinos	ancashinas
cuzqueños	cuzqueñas
cusqueños	cusqueñas
tacneños	tacneñas
doctrinarios	doctrinarias
arregladores	arregladoras
simpatizadores	simpatizadoras
educadores	educadoras
postiladores	postiladoras
megalómanos	megalómanas
costaleros	costaleras
presuntuosos	presuntuosas
marranos	marranas
choteadores	choteadoras
licántropos	licántropas
chivatos	chivatas
barrenderos	barrenderas
bibliófilos	bibliófilas
mocosos	mocosas
gijoneses	gijonesas
chiclaneros	chiclaneras
melómanos	melómanas
adoradores	adoradoras
apicultores	apicultoras
acupuntores	acupuntoras
bloggeros	bloggeras
chinamperos	chinamperas
demiurgos	demiurgas
zapotecos	zapotecas
lusitanos	lusitanas
tangueros	tangueras
paletos	paletas
contestatarios	contestatarias
pacificadores	pacificadoras
energúmenos	energúmenas
adiestradores	adiestradoras
publicadores	publicadoras
represaliados	represaliadas
entendedores	entendedoras
usufructuarios	usufructuarias
regiomontanos	regiomontanas
morochos	morochas
rufianes	rufianas
timidos	timidas
forjadores	forjadoras
lugareños	lugareñas
horticultores	horticultoras
macacos	macacas
jarochos	jarochas
taberneros	taberneras
misántropos	misántropas
siameses	siamesas
radiólogos	radiólogas
cuadragenarios	cuadragenarias
tuiteros	tuiteras
madereros	madereras
amerindios	amerindias
topógrafos	topógrafas
huachafos	huachafas
donatarios	donatarias
reposteros	reposteras
navieros	navieras
falsificadores	falsificadoras
taxónomos	taxónomas
guajiros	guajiras
dignatarios	dignatarias
malhechores	malhechoras
inadaptados	inadaptadas
convidados	convidadas
coproductores	coproductoras
cesionarios	cesionarias
zorrillos	zorrillas
chechenos	chechenas
hospederos	hospederas
sonámbulos	sonámbulas
etnógrafos	etnógrafas
viceconsejeros	viceconsejeras
usureros	usureras
preclasificados	preclasificadas
comercializadores	comercializadoras
siríacos	siríacas
siriacos	siriacas
licitadores	licitadoras
ofensores	ofensoras
librepensadores	librepensadoras
enseñadores	enseñadoras
exsenadores	exsenadoras
ex-senadores	ex-senadoras
avisadores	avisadoras
ventrílocuos	ventrílocuas
exfuncionarios	exfuncionarias
ex-funcionarios	ex-funcionarias
replicadores	replicadoras
escolásticos	escolásticas
geofísicos	geofísicas
briólogos	briólogas
catadores	catadoras
liquidadores	liquidadoras
piamonteses	piamontesas
configuradores	configuradoras
porteadores	porteadoras
sexólogos	sexólogas
moradores	moradoras
quisquillosos	quisquillosas
lexicógrafos	lexicógrafas
asilados	asiladas
asalariados	asalariadas
detractores	detractoras
tataranietos	tataranietas
destripadores	destripadoras
chamacos	chamacas
apostadores	apostadoras
aparejadores	aparejadoras
caucásicos	caucásicas
libradores	libradoras
revendedores	revendedoras
cacereños	cacereñas
ufólogos	ufólogas
afiladores	afiladoras
monopólicos	monopólicas
cantineros	cantineras
timadores	timadoras
acólitos	acólitas
tracios	tracias
alsacianos	alsacianas
correligionarios	correligionarias
peladores	peladoras
pamploneses	pamplonesas
amnésicos	amnésicas
puntanos	puntanas
perezosos	perezosas
gascones	gasconas
diablillos	diablillas
grafiteros	grafiteras
filisteos	filisteas
perceptores	perceptoras
patateros	patateras
tacaños	tacañas
mezquinos	mezquinas
mesquinos	mesquinas
desvergonzados	desvergonzadas
vicedecanos	vicedecanas
celtíberos	celtíberas
celtiberos	celtiberas
comediógrafos	comediógrafas
asmáticos	asmáticas
jacobinos	jacobinas
sombrereros	sombrereras
democristianos	democristianas
calígrafos	calígrafas
hipnotizadores	hipnotizadoras
contertulios	contertulias
capacitadores	capacitadoras
chicanos	chicanas
cebuanos	cebuanas
recopiladores	recopiladoras
removedores	removedoras
coeditores	coeditoras
franquiciadores	franquiciadoras
partisanos	partisanas
encuestadores	encuestadoras
interrogadores	interrogadoras
veinteañeros	veinteañeras
treintañeros	treintañeras
gastrónomos	gastrónomas
pedorros	pedorras
anestesiólogos	anestesiólogas
algólogos	algólogas
urbanizadores	urbanizadoras
forofos	forofas
chaparros	chaparras
teleoperadores	teleoperadoras
botelleros	botelleras
valones	valonas
travestidos	travestidas
suevos	suevas
radioaficionados	radioaficionadas
subprocuradores	subprocuradoras
acordeoneros	acordeoneras
araucanos	araucanas
carretilleros	carretilleras
actuarios	actuarias
fueguinos	fueguinas
beduinos	beduinas
demostradores	demostradoras
sustentadores	sustentadoras
adúlteros	adúlteras
podólogos	podólogas
masturbadores	masturbadoras
barranquilleros	barranquilleras
celiacos	celiacas
celíacos	celíacas
endocrinólogos	endocrinólogas
ojeadores	ojeadoras
modeladores	modeladoras
legatarios	legatarias
pirómanos	pirómanas
frisones	frisonas
maniacos	maniacas
filibusteros	filibusteras
viticultores	viticultoras
repobladores	repobladoras
bellacos	bellacas
madrugadores	madrugadoras
pontevedreses	pontevedresas
exasesores	exasesoras
ex-asesores	ex-asesoras
surferos	surferas
guineos	guineas
objetores	objetoras
licenciatarios	licenciatarias
licenciados	licenciadas
merengueros	merengueras
comentadores	comentadoras
prestidigitadores	prestidigitadoras
labriegos	labriegas
pizzeros	pizzeras
cultores	cultoras
invalidos	invalidas
inválidos	inválidas
condiscípulos	condiscípulas
bibliógrafos	bibliógrafas
eliminadores	eliminadoras
consignatarios	consignatarias
signatarios	signatarias
aduladores	aduladoras
locatarios	locatarias
santandereanos	santandereanas
pitagóricos	pitagóricas
terminadores	terminadoras
iletrados	iletradas
castigadores	castigadoras
litógrafos	litógrafas
tahitianos	tahitianas
aguadores	aguadoras
wagnerianos	wagnerianas
biznietos	biznietas
pordioseros	pordioseras
extorsionadores	extorsionadoras
feroeses	feroesas
hipocondríacos	hipocondríacas
hipocondriacos	hipocondriacas
socialcristianos	socialcristianas
fedatarios	fedatarias
epidemiólogos	epidemiólogas
reguetoneros	reguetoneras
saqueadores	saqueadoras
vicejefes	vicejefas
bienhechores	bienhechoras
malandros	malandras
malandrines	malandrinas
rateros	rateras
comiqueros	comiqueras
conuqueros	conuqueras
bacteriólogos	bacteriólogas
expendedores	expendedoras
gastroenterólogos	gastroenterólogas
levantadores	levantadoras
sediciosos	sediciosas
amotinadores	amotinadoras
abonados	abonadas
infrascritos	infrascritas
subscriptores	subscriptoras
suscritores	suscritoras
subscritores	subscritoras
vallecaucanos	vallecaucanas
cananeos	cananeas
horneros	horneras
prebenjamines	prebenjaminas
lenceros	lenceras
araneses	aranesas
tebanos	tebanas
improvisadores	improvisadoras
puneños	puneñas
saboteadores	saboteadoras
ostrogodos	ostrogodas
cocaleros	cocaleras
tamborileros	tamborileras
otorrinolaringólogos	otorrinolaringólogas
algodoneros	algodoneras
feligreses	feligresas
parroquianos	parroquianas
telespectadores	telespectadoras
copiadores	copiadoras
taponadores	taponadoras
quinceañeros	quinceañeras
quincuagenarios	quincuagenarias
sexagenarios	sexagenarias
berneses	bernesas
entintadores	entintadoras
mitómanos	mitómanas
despachadores	despachadoras
sesenteros	sesenteras
setenteros	setenteras
oriolanos	oriolanas
sabaneros	sabaneras
friulanos	friulanas
polinesios	polinesias
santiagueros	santiagueras
oceanógrafos	oceanógrafas
estibadores	estibadoras
segadores	segadoras
propagadores	propagadoras
billonarios	billonarias
multibillonarios	multibillonarias
jerónimos	jerónimas
choriceros	choriceras
auspiciadores	auspiciadoras
reumatólogos	reumatólogas
cementeros	cementeras
arroceros	arroceras
pollinos	pollinas
ovejeros	ovejeras
exembajadores	exembajadoras
ex-embajadores	ex-embajadoras
acomodadores	acomodadoras
invocadores	invocadoras
aulladores	aulladoras
antólogos	antólogas
sismólogos	sismólogas
abstemios	abstemias
agoreros	agoreras
zánganos	zánganas
alcahuetes	alcahuetas
almaceneros	almaceneras
guayaneses	guayanesas
potentados	potentadas
balineses	balinesas
talladores	talladoras
majaderos	majaderas
geotécnicos	geotécnicas
anticristianos	anticristianas
anti-cristianos	anti-cristianas
septuagenarios	septuagenarias
avilesinos	avilesinas
kinesiólogos	kinesiólogas
bilbaínos	bilbainas
senyores	senyoras
retrogrados	retrogradas
heladeros	heladeras
amadores	amadoras
prosecretarios	prosecretarias
menganos	menganas
bateros	bateras
gabachos	gabachas
pucelanos	pucelanas
borgoñones	borgoñonas
pochos	pochas
groenlandeses	groenlandesas
dinamarqueses	dinamarquesas
semiólogos	semiólogas
bachateros	bachateras
ferrocarrileros	ferrocarrileras
pampeanos	pampeanas
atuneros	atuneras
prostitutos	prostitutas
cuenteros	cuenteras
avileses	avilesas
murcianos	murcianas
fideicomisarios	fideicomisarias
panfletarios	panfletarias
tapiceros	tapiceras
parteros	parteras
mesoneros	mesoneras
exrectores	exrectoras
ex-rectores	ex-rectoras
portorriqueños	portorriqueñas
climatólogos	climatólogas
colectiveros	colectiveras
ictiólogos	ictiólogas
vidrieros	vidrieras
chalados	chaladas
sonsos	sonsas
zonzos	zonzas
tiroleses	tirolesas
rumberos	rumberas
ruteros	ruteras
mirandeses	mirandesas
guardadores	guardadoras
violeros	violeras
silleros	silleras
rocieros	rocieras
martilleros	martilleras
subastadores	subastadoras
melenudos	melenudas
descargadores	descargadoras
gibraltareños	gibraltareñas
saharianos	saharianas
cosmólogos	cosmólogas
adivinadores	adivinadoras
boloñeses	boloñesas
cartoneros	cartoneras
tramperos	tramperas
chatarreros	chatarreras
plagiadores	plagiadoras
epicúreos	epicúreas
talaveranos	talaveranas
cocreadores	cocreadoras
co-creadores	co-creadoras
paleros	paleras
acaparadores	acaparadoras
defraudadores	defraudadoras
taumaturgos	taumaturgas
macabeos	macabeas
cuáqueros	cuáqueras
jugueteros	jugueteras
doradores	doradoras
excavadores	excavadoras
quisqueyanos	quisqueyanas
etólogos	etólogas
extracomunitarios	extracomunitarias
neoconservadores	neoconservadoras
partidores	partidoras
quebequeses	quebequesas
lorquinos	lorquinas
utileros	utileras
mieleros	mieleras
vulcanólogos	vulcanólogas
destiladores	destiladoras
catrachos	catrachas
alcalaínos	alcalaínas
boyeros	boyeras
festeros	festeras
fiesteros	fiesteras
farreros	farreras
marselleses	marsellesas
javaneses	javanesas
exalumnos	exalumnas
ex-alumnos	ex-alumnas
parapsicólogos	parapsicólogas
parasicólogos	parasicólogas
psicasténicos	psicasténicas
sicasténicos	sicasténicas
norteamericanos	norteamericanas
nativoamericanos	nativoamericanas
cubanoamericanos	cubanoamericanas
italoamericanos	italoamericanas
indoamericanos	indoamericanas
exesposos	exesposas
ex-esposos	ex-esposas
nutriólogos	nutriólogas
quiosqueros	quiosqueras
kiosqueros	kiosqueras
vénetos	vénetas
nonagenarios	nonagenarias
notificadores	notificadoras
plantadores	plantadoras
buhoneros	buhoneras
ribagorzanos	ribagorzanas
tuberculosos	tuberculosas
galaicos	galaicas
conseguidores	conseguidoras
carabobeños	carabobeñas
herpetólogos	herpetólogas
traperos	traperas
párvulos	párvulas
originadores	originadoras
viñamarinos	viñamarinas
utreranos	utreranas
sinólogos	sinólogas
transilvanos	transilvanas
noteros	noteras
ourensanos	ourensanas
orensanos	orensanas
neumólogos	neumólogas
falsarios	falsarias
palurdos	palurdas
calabreses	calabresas
politiqueros	politiqueras
chalacos	chalacas
valdivianos	valdivianas
cantadores	cantadoras
loqueros	loqueras
nubios	nubias
cristeros	cristeras
majoreros	majoreras
apoyadores	apoyadoras
exdirectivos	exdirectivas
ex-directivos	ex-directivas
falladores	falladoras
rifeños	rifeñas
exempleados	exempleadas
ex-empleados	ex-empleadas
farmacólogos	farmacólogas
alergólogos	alergólogas
britanos	britanas
tuneros	tuneras
cuencanos	cuencanas
pasiegos	pasiegas
consuegros	consuegras
hematólogos	hematólogas
lanzaroteños	lanzaroteñas
chuquisaqueños	chuquisaqueñas
inmunólogos	inmunólogas
arrabaleros	arrabaleras
bluseros	bluseras
bauseros	bauseras
recaderos	recaderas
meditadores	meditadoras
giradores	giradoras
moldeadores	moldeadoras
angevinos	angevinas
cátaros	cátaras
cachacos	cachacas
vascones	vasconas
segundogénitos	segundogénitas
plagiarios	plagiarias
pequineses	pequinesas
amorreos	amorreas
demógrafos	demógrafas
mafufos	mafufas
magufos	magufas
nefrólogos	nefrólogas
deshollinadores	deshollinadoras
baqueanos	baqueanas
baquianos	baquianas
vaqueanos	vaqueanas
angloamericanos	angloamericanas
paseadores	paseadoras
porqueros	porqueras
virginianos	virginianas
vermonteses	vermontesas
caminadores	caminadoras
tarascos	tarascas
pastilleros	pastilleras
seores	seoras
escolapios	escolapias
organeros	organeras
epistemólogos	epistemólogas
graffiteros	graffiteras
abisinios	abisinias
aquitanos	aquitanas
curtidores	curtidoras
enunciadores	enunciadoras
alcoyanos	alcoyanas
beodos	beodas
ebrios	ebrias
embriagadores	embriagadoras
dipsomaníacos	dipsomaníacas
dipsomaniacos	dipsomaniacas
dulceros	dulceras
confiteros	confiteras
fisicoquímicos	fisicoquímicas
taquígrafos	taquígrafas
prevaricadores	prevaricadoras
logroñeses	logroñesas
sanmarquinos	sanmarquinas
sanmarqueños	sanmarqueñas
picapedreros	picapedreras
jabatos	jabatas
temporeros	temporeras
bordadores	bordadoras
holguineros	holguineras
postuladores	postuladoras
virólogos	virólogas
tintoreros	tintoreras
declamadores	declamadoras
cuestionadores	cuestionadoras
pastusos	pastusas
oscos	oscas
transcriptores	transcriptoras
touroperadores	touroperadoras
sacadores	sacadoras
concuñados	concuñadas
copresentadores	copresentadoras
follamigos	follamigas
antequeranos	antequeranas
lojanos	lojanas
medianeros	medianeras
apiladores	apiladoras
europarlamentarios	europarlamentarias
exprocuradores	exprocuradoras
comunicólogos	comunicólogas
pipiolos	pipiolas
mecanógrafos	mecanógrafas
pisanos	pisanas
geoquímicos	geoquímicas
rodadores	rodadoras
parranderos	parranderas
soderos	soderas
criptógrafos	criptógrafas
neurobiólogos	neurobiólogas
prehistoriadores	prehistoriadoras
nortinos	nortinas
historiógrafos	historiógrafas
ilirios	ilirias
peineros	peineras
confucianos	confucianas
cardiologos	cardiologas
rutenos	rutenas
anoréxicos	anoréxicas
copleros	copleras
léperos	léperas
marchosos	marchosas
agroquímicos	agroquímicas
charnegos	charnegas
pulperos	pulperas
dacios	dacias
rotarios	rotarias
galleros	galleras
nabateos	nabateas
neuropsicólogos	neuropsicólogas
neurosicólogos	neurosicólogas
vetones	vetonas
ejidatarios	ejidatarias
teotihuacanos	teotihuacanas
margariteños	margariteñas
sanluqueños	sanluqueñas
camagüeyanos	camagüeyanas
incitadores	incitadoras
codescubridores	codescubridoras
linieros	linieras
detentadores	detentadoras
marchadores	marchadoras
legitimarios	legitimarias
leguleyos	leguleyas
congoleses	congolesas
mamporreros	mamporreras
difamadores	difamadoras
alanos	alanas
churreros	churreras
guantanameros	guantanameras
peleteros	peleteras
bordeleses	bordelesas
expósitos	expósitas
contempladores	contempladoras
güelfos	güelfas
resineros	resineras
alpujarreños	alpujarreñas
prosélitos	prosélitas
galapagueños	galapagueñas
pornógrafos	pornógrafas
mercadólogos	mercadólogas
contradictores	contradictoras
consumadores	consumadoras
hojalateros	hojalateras
castellanoleoneses	castellanoleonesas
afroperuanos	afroperuanas
alfabetizadores	alfabetizadoras
especificadores	especificadoras
numantinos	numantinas
cocainómanos	cocainómanas
exconvictos	exconvictas
ex-convictos	ex-convictas
hagiógrafos	hagiógrafas
futurólogos	futurólogas
igualadores	igualadoras
museólogos	museólogas
peripatéticos	peripatéticas
entregadores	entregadoras
trompeteros	trompeteras
balseros	balseras
gibelinos	gibelinas
padrotes	madrotas
embotelladores	embotelladoras
infectólogos	infectólogas
faroleros	faroleras
lisonjeros	lisonjeras
herreños	herreñas
entalladores	entalladoras
fitogeógrafos	fitogeógrafas
lidiadores	lidiadoras
mazatecos	mazatecas
moguereños	moguereñas
cristaleros	cristaleras
troveros	troveras
perfeccionadores	perfeccionadoras
carteadores	carteadoras
valacos	valacas
matreros	matreras
herradores	herradoras
decidores	decidoras
necrófilos	necrófilas
abejeros	abejeras
catalogadores	catalogadoras
anti-americanos	anti-americanas
extrabajadores	extrabajadoras
ex-trabajadores	ex-trabajadoras
aguateros	aguateras
campiranos	campiranas
nenes	nenas
esparcidores	esparcidoras
ampurdaneses	ampurdanesas
caucasianos	caucasianas
teósofos	teósofas
loreneses	lorenesas
atacameños	atacameñas
santanecos	santanecas
aragüeños	aragüeñas
usurarios	usurarias
zopencos	zopencas
cuatreros	cuatreras
iquiqueños	iquiqueñas
aparceros	aparceras
sardineros	sardineras
cheros	cheras
suplidores	suplidoras
abastecedores	abastecedoras
cuchilleros	cuchilleras
licios	licias
iroqueses	iroquesas
saboyanos	saboyanas
avariciosos	avariciosas
cosecheros	cosecheras
judeoconversos	judeoconversas
pedigüeños	pedigüeñas
maracuchos	maracuchas
maracaiberos	maracaiberas
hilanderos	hilanderas
despenseros	despenseras
villaclareños	villaclareñas
reconocedores	reconocedoras
taqueros	taqueras
poceros	poceras
gondoleros	gondoleras
toneleros	toneleras
gracianos	gracianas
huertanos	huertanas
fajadores	fajadoras
palomeros	palomeras
ayoreos	ayoreas
gastadores	gastadoras
componedores	componedoras
ensayadores	ensayadoras
estomatólogos	estomatólogas
ecijanos	ecijanas
intimidadores	intimidadoras
burkineses	burkinesas
tabaqueros	tabaqueras
chinchaleros	chinchaleras
guiadores	guiadoras
musicalizadores	musicalizadoras
tocopillanos	tocopillanas
corifeos	corifeas
ariqueños	ariqueñas
coherederos	coherederas
recreadores	recreadoras
esmeraldeños	esmeraldeñas
funebreros	funebreras
hidrógrafos	hidrógrafas
cacaoteros	cacaoteras
catecúmenos	catecúmenas
dogones	dogonas
laneros	laneras
tocaores	tocaoras
tramitadores	tramitadoras
hacheros	hacheras
molosos	molosas
planchadores	planchadoras
neurofisiólogos	neurofisiólogas
pachucos	pachucas
fletadores	fletadoras
auxiliadores	auxiliadoras
censuradores	censuradoras
michos	michas
neonatólogos	neonatólogas
escrutadores	escrutadoras
asignatarios	asignatarias
embriólogos	embriólogas
iqueños	iqueñas
cangrejeros	cangrejeras
asistidores	asistidoras
carmelitanos	carmelitanas
veroneses	veronesas
dinamiteros	dinamiteras
aracnólogos	aracnólogas
envenenadores	envenenadoras
milongueros	milongueras
fonoaudiólogos	fonoaudiólogas
lateros	lateras
suplantadores	suplantadoras
vacanos	vacanas
noveleros	noveleras
bígamos	bígamas
mitólogos	mitólogas
corianos	corianas
incumplidores	incumplidoras
asgardianos	asgardianas
chaqueteros	chaqueteras
timbaleros	timbaleras
viñadores	viñadoras
reseñadores	reseñadoras
desclasados	desclasadas
santafereños	santafereñas
cumanos	cumanas
cienfuegueros	cienfuegueras
istmeños	istmeñas
frisios	frisias
paleógrafos	paleógrafas
baturros	baturras
influenciadores	influenciadoras
acechadores	acechadoras
lucentinos	lucentinas
prospectores	prospectoras
guanacastecos	guanacastecas
argivos	argivas
museógrafos	museógrafas
cetreros	cetreras
imperadores	imperadoras
misionarios	misionarias
escuincles	escuinclas
pinoleros	pinoleras
concertadores	concertadoras
asuncenos	asuncenas
telepredicadores	telepredicadoras
meleros	meleras
contusos	contusas
fitopatólogos	fitopatólogas
toxicólogos	toxicólogas
heroinómanos	heroinómanas
miraflorinos	miraflorinas
cabilderos	cabilderas
coorganizadores	coorganizadoras
castellanomanchegos	castellanomanchegas
primatólogos	primatólogas
sieneses	sienesas
antologadores	antologadoras
heredianos	heredianas
descifradores	descifradoras
palermitanos	palermitanas
indagadores	indagadoras
coescritores	coescritoras
tudelanos	tudelanas
tañedores	tañedoras
bibliotecólogos	bibliotecólogas
escanciadores	escanciadoras
riobambeños	riobambeñas
malacólogos	malacólogas
baezanos	baezanas
podadores	podadoras
facinerosos	facinerosas
tocarios	tocarias
metecos	metecas
apureños	apureñas
morelianos	morelianas
esenios	esenias
autobuseros	autobuseras
puesteros	puesteras
chulapos	chulapas
zutanos	zutanas
mitógrafos	mitógrafas
cucuteños	cucuteñas
henequeneros	henequeneras
carpetanos	carpetanas
roncaleses	roncalesas
triperos	triperas
floricultores	floricultoras
longobardos	longobardas
versificadores	versificadoras
ruleteros	ruleteras
cuadripléjicos	cuadripléjicas
tetrapléjicos	tetrapléjicas
algonquinos	algonquinas
sayagueses	sayaguesas
tocólogos	tocólogas
opinólogos	opinólogas
