él	ella
ellos	ellas
yo	yo
tú	tú
usted	usted
ustedes	ustedes
nosotros	nosotras
vosotros	vosotras
otro	otra
otros	otras
varios	varias
ciertos	ciertas
cierto	cierta
pocos	pocas
muchos	muchas
tantos	tantas
todos	todas
demasiados	demasiadas
unos	unas
alguno	alguna
algún	alguna
éste	ésta
ése	ésa
aquél	aquélla
aquello	aquella
aquellos	aquellas
aquéllos	aquéllas
tipo	tipa
tipazo	tipaza
presidente	presidenta
paparazzi	paparazzi
ejecutivo	ejecutiva
negociante	negocianta
hijo	hija
hijito	hijita
mijo	mija
mijito	mijita
intendente	intendenta
viceintendente	viceintendenta
manicuro	manicura
doctorcito	doctorcita
mayorcito	mayorcita
nuevecito	nuevecita
exponedor	exponedora
arbitrador	arbitradora
criticón	criticona
criticastro	criticastra
criticador	criticadora
figurante	figuranta
muerto	muerta
dormido	dormida
atento	atenta
disciplinario	disciplinaria
disciplinado	disciplinada
depositador	depositadora
adoptador	adoptadora
usuario	usuaria
conocido	conocida
amigo	amiga
amiguito	amiguita
rey	reina
virrey	virreina
zar	zarina
papa	papisa
zagal	zagala
eclesiástico	eclesiástica
provicario	provicaria
vicario	vicaria
infiltrado	infiltrada
penitente	penitenta
espadachín	espadachina
eugenésico	eugenésica
regente	regenta
pretendiente	pretendienta
concertino	concertina
farsante	farsanta
pajarero	pajarera
grosero	grosera
bedel	bedela
funámbulo	funámbula
académico	académica
antipático	antipática
autoritario	autoritaria
danzante	danzanta
palabrero	palabrera
filántropo	filántropa
zoroástrico	zoroástrica
fernandino	fernandina
liante	lianta
ético	ética
cronólogo	cronóloga
pedicuro	pedicura
confederado	confederada
antiacadémico	antiacadémica
anti-académico	anti-académica
bolivariano	bolivariana
micrográfico	micrográfica
humano	humana
favorito	favorita
maldito	maldita
individuo	individua
cliente	clienta
excliente	exclienta
exnovio	exnovia
ex-novio	ex-novia
jugador	jugadora
soldador	soldadora
jefe	jefa
escritor	escritora
técnico	técnica
ministro	ministra
campeón	campeona
viejo	vieja
viejecito	viejecita
darwiniano	darwiniana
físico	física
don	doña
candidato	candidata
alcalde	alcaldesa
enviado	enviada
querido	querida
famoso	famosa
famosillo	famosilla
secretario	secretaria
servidor	servidora
científico	científica
navegador	navegadora
productor	productora
enemigo	enemiga
propietario	propietaria
capitán	capitana
editor	editora
alumno	alumna
dueño	dueña
encargado	encargada
socio	socia
fundador	fundadora
europeo	europea
diputado	diputada
crítico	crítica
pintor	pintora
patrón	patrona
lindo	linda
conductor	conductora
marítimo	marítima
obispo	obispa
gato	gata
perro	perra
perrito	perrita
curioso	curiosa
meticuloso	meticulosa
escrupuloso	escrupulosa
minucioso	minuciosa
músico	música
americano	americana
samoamericano	samoamericana
empresario	empresaria
trabajador	trabajadora
loco	loca
detenido	detenida
conde	condesa
vecino	vecina
administrador	administradora
experto	experta
delantero	delantera
creador	creadora
gigante	giganta
santo	santa
invitado	invitada
desconocido	desconocida
latino	latina
funcionario	funcionaria
jurado	jurada
consumidor	consumidora
vicepresidente	vicepresidenta
acusado	acusada
desaparecido	desaparecida
externo	externa
investigador	investigadora
mantenido	mantenida
lógico	lógica
teutón	teutona
sucesor	sucesora
condenado	condenada
papá	mamá
universitario	universitaria
enfermo	enferma
casado	casada
gerente	gerenta
subgerente	subgerenta
exgerente	exgerenta
fotógrafo	fotógrafa
revolucionario	revolucionaria
animalístico	animalística
senador	senadora
enamorado	enamorada
embajador	embajadora
creativo	creativa
convencido	convencida
espectador	espectadora
defensor	defensora
operador	operadora
asesor	asesora
judío	judía
vendedor	vendedora
séptimo	séptima
dependiente	dependienta
diablo	diabla
mandatario	mandataria
lobo	loba
lobito	lobita
portero	portera
profeta	profetisa
corredor	corredora
concejal	concejala
mono	mona
derrotado	derrotada
agregado	agregada
sanitario	sanitaria
pastor	pastora
león	leona
colaborador	colaboradora
protector	protectora
químico	química
adoptado	adoptada
monitor	monitora
republicano	republicana
moderado	moderada
mecánico	mecánica
heredero	heredera
aficionado	aficionada
rector	rectora
tonto	tonta
tontito	tontita
tramposo	tramposa
traicionero	traicionera
embustero	embustera
nieto	nieta
nietito	nietita
holandés	holandesa
doméstico	doméstica
ciego	ciega
informático	informática
viajero	viajera
matemático	matemática
anciano	anciana
goleador	goleadora
ferroviario	ferroviaria
sabio	sabia
controlador	controladora
conservador	conservadora
dragón	dragona
innovador	innovadora
anónimo	anónima
obrero	obrera
flamenco	flamenca
narrador	narradora
comprador	compradora
guerrero	guerrera
gallego	gallega
voluntario	voluntaria
dictador	dictadora
parlamentario	parlamentaria
gordo	gorda
bibliotecario	bibliotecaria
predecesor	predecesora
gestor	gestora
vampiro	vampira
homónimo	homónima
directivo	directiva
veterano	veterana
valenciano	valenciana
ladrón	ladrona
nativo	nativa
luchador	luchadora
presentador	presentadora
pionero	pionera
catedrático	catedrática
bancario	bancaria
arquero	arquera
discípulo	discípula
conejo	coneja
conejito	conejita
sospechoso	sospechosa
emprendedor	emprendedora
esclavo	esclava
espabilado	espabilada
pícaro	pícara
tunante	tunanta
vencedor	vencedora
explorador	exploradora
promotor	promotora
contador	contadora
cazador	cazadora
distribuidor	distribuidora
organizador	organizadora
legislador	legisladora
cirujano	cirujana
publicitario	publicitaria
observador	observadora
comisario	comisaria
pasajero	pasajera
opositor	opositora
tutor	tutora
primitivo	primitiva
millonario	millonaria
dramaturgo	dramaturga
seguidor	seguidora
regulador	reguladora
magistrado	magistrada
empleador	empleadora
cordero	cordera
veterinario	veterinaria
criado	criada
redactor	redactora
cantautor	cantautora
portador	portadora
adversario	adversaria
rubio	rubia
amoroso	amorosa
campesino	campesina
didáctico	didáctica
partidario	partidaria
asturiano	asturiana
interino	interina
inventor	inventora
torero	torera
estadístico	estadística
pavo	pava
deudor	deudora
inspector	inspectora
desarrollador	desarrolladora
cuñado	cuñada
infante	infanta
astrónomo	astrónoma
tenedor	tenedora
párroco	párroca
ibérico	ibérica
instructor	instructora
mudo	muda
borracho	borracha
consultor	consultora
pariente	parienta
soltero	soltera
corrupto	corrupta
destinatario	destinataria
canario	canaria
reportero	reportera
inversor	inversora
emotivo	emotiva
serbio	serbia
estúpido	estúpida
payaso	payasa
constructor	constructora
palestino	palestina
mojado	mojada
precursor	precursora
fracasado	fracasada
guardián	guardiana
enano	enana
acreedor	acreedora
bizantino	bizantina
rústico	rústica
fanático	fanática
unitario	unitaria
mensajero	mensajera
burro	burra
afiliado	afiliada
ilustrador	ilustradora
lanzador	lanzadora
graduado	graduada
sudamericano	sudamericana
moreno	morena
morenito	morenita
zorro	zorra
zorrito	zorrita
locutor	locutora
antecesor	antecesora
demandado	demandada
rapero	rapera
procurador	procuradora
decano	decana
supervisor	supervisora
místico	mística
mentor	mentora
cachorro	cachorra
cachorrito	cachorrita
padrino	madrina
pescador	pescadora
notario	notaria
subsecretario	subsecretaria
beneficiario	beneficiaria
siervo	sierva
marinero	marinera
salvador	salvadora
competidor	competidora
sevillano	sevillana
patrocinador	patrocinadora
guerrillero	guerrillera
romero	romera
vago	vaga
tirano	tirana
adicto	adicta
egresado	egresada
patriarca	matriarca
carpintero	carpintera
seleccionador	seleccionadora
intermediario	intermediaria
artesano	artesana
interlocutor	interlocutora
mediador	mediadora
puertorriqueño	puertorriqueña
andromedano	andromedana
conquistador	conquistadora
regidor	regidora
corrector	correctora
orador	oradora
cajero	cajera
exiliado	exiliada
yerno	nuera
vigésimo	vigésima
apoderado	apoderada
jardinero	jardinera
burgués	burguesa
ganadero	ganadera
pensador	pensadora
psíquico	psíquica
flaco	flaca
flaquito	flaquita
prematuro	prematura
anotador	anotadora
noticiero	noticiera
navarro	navarra
agricultor	agricultora
exportador	exportadora
tirador	tiradora
neoclásico	neoclásica
perdedor	perdedora
colector	colectora
honorario	honoraria
transmisor	transmisora
ingenuo	ingenua
murciélago	murciélaga
erudito	erudita
destructor	destructora
cofundador	cofundadora
tico	tica
jubilado	jubilada
animador	animadora
cabrón	cabrona
clandestino	clandestina
peregrino	peregrina
instalador	instaladora
oriundo	oriunda
prefecto	prefecta
estudioso	estudiosa
loro	lora
preparador	preparadora
auditor	auditora
huérfano	huérfana
peón	peona
sordo	sorda
laico	laica
tapado	tapada
admirador	admiradora
limpiador	limpiadora
colorado	colorada
multimillonario	multimillonaria
refugiado	refugiada
gatito	gatita
emulador	emuladora
subdirector	subdirectora
tesorero	tesorera
depredador	depredadora
progenitor	progenitora
inquilino	inquilina
homólogo	homóloga
bárbaro	bárbara
predicador	predicadora
sapo	sapa
coautor	coautora
virtuoso	virtuosa
alcohólico	alcohólica
seductor	seductora
escéptico	escéptica
comunicador	comunicadora
viceministro	viceministra
calvo	calva
franciscano	franciscana
pillo	pilla
serrano	serrana
devoto	devota
cantor	cantora
paisano	paisana
diplomado	diplomada
galés	galesa
papi	mami
papito	mamita
papacito	mamacita
topo	topa
antepasado	antepasada
perito	perita
hotelero	hotelera
pendejo	pendeja
subordinado	subordinada
rockero	rockera
mafioso	mafiosa
letrado	letrada
desgraciado	desgraciada
barcelonés	barcelonesa
recibidor	recibidora
cuidador	cuidadora
rabino	rabina
vizconde	vizcondesa
malagueño	malagueña
francotirador	francotiradora
elector	electora
exjugador	exjugadora
llavero	llavera
cautivo	cautiva
pelado	pelada
mendigo	mendiga
leonés	leonesa
tigre	tigresa
extremeño	extremeña
bombero	bombera
occitano	occitana
escribano	escribana
chiquito	chiquita
chiquitito	chiquitita
pequeñín	pequeñina
chivo	chiva
libertario	libertaria
camello	camella
vagabundo	vagabunda
asegurador	aseguradora
soñador	soñadora
operario	operaria
pagano	pagana
mercenario	mercenaria
inhibidor	inhibidora
alpino	alpina
visionario	visionaria
convertidor	convertidora
vikingo	vikinga
cínico	cínica
tibetano	tibetana
ginecólogo	ginecóloga
ancestro	ancestra
centroamericano	centroamericana
mestizo	mestiza
formador	formadora
labrador	labradora
matador	matadora
enfermero	enfermera
vegetariano	vegetariana
becario	becaria
osito	osita
oso	osa
patito	patita
pato	pata
cerdo	cerda
cerdito	cerdita
expositor	expositora
geógrafo	geógrafa
precandidato	precandidata
manipulador	manipuladora
curador	curadora
infractor	infractora
geólogo	geóloga
cartero	cartera
propulsor	propulsora
mezclador	mezcladora
pedagogo	pedagoga
triunfador	triunfadora
facilitador	facilitadora
importador	importadora
bastardo	bastarda
transportador	transportadora
filólogo	filóloga
lexicográfico	lexicográfica
lexicológico	lexicológica
arrendatario	arrendataria
sureño	sureña
panadero	panadera
violador	violadora
prelado	prelada
consolador	consoladora
reductor	reductora
coreógrafo	coreógrafa
metafísico	metafísica
entrevistador	entrevistadora
prófugo	prófuga
gringo	gringa
asno	asna
germano	germana
bisabuelo	bisabuela
abuelito	abuelita
principito	princesita
ecléctico	ecléctica
integrador	integradora
manchego	manchega
hidalgo	hidalga
fugitivo	fugitiva
prior	priora
repartidor	repartidora
coqueto	coqueta
homenajeado	homenajeada
basurero	basurera
marciano	marciana
venusino	venusina
saturniano	saturniana
abridor	abridora
negociador	negociadora
cinéfilo	cinéfila
reparador	reparadora
interventor	interventora
arameo	aramea
disparador	disparadora
divorciado	divorciada
disperso	dispersa
platónico	platónica
emigrado	emigrada
norteño	norteña
gaditano	gaditana
intruso	intrusa
peatón	peatona
profano	profana
barbero	barbera
libertador	libertadora
hermanastro	hermanastra
pervertido	pervertida
confesor	confesora
astrólogo	astróloga
provocador	provocadora
marginado	marginada
pisco	pisca
superintendente	superintendenta
corso	corsa
camionero	camionera
prusiano	prusiana
estafador	estafadora
multiplicador	multiplicadora
archiduque	archiduquesa
bandido	bandida
bloqueador	bloqueadora
relator	relatora
riojano	riojana
cantaor	cantaora
bateador	bateadora
potro	potra
analizador	analizadora
beato	beata
postor	postora
politólogo	politóloga
obeso	obesa
californiano	californiana
benefactor	benefactora
vicegobernador	vicegobernadora
ex-presidente	ex-presidenta
expresidente	expresidenta
copresidente	copresidenta
ganso	gansa
paleontólogo	paleontóloga
acumulador	acumuladora
perseguidor	perseguidora
cornudo	cornuda
usurpador	usurpadora
liberador	liberadora
forastero	forastera
discapacitado	discapacitada
bretón	bretona
sicario	sicaria
escandinavo	escandinava
luso	lusa
perturbador	perturbadora
secuestrador	secuestradora
fulano	fulana
síndico	síndica
pelotero	pelotera
joyero	joyera
acomodado	acomodada
hacendado	hacendada
emisario	emisaria
matón	matona
orientador	orientadora
agrónomo	agrónoma
literato	literata
arrendador	arrendadora
desempleado	desempleada
inquisidor	inquisidora
comendador	comendadora
ropero	ropera
benedictino	benedictina
dermatólogo	dermatóloga
bioquímico	bioquímica
canterano	canterana
cortesano	cortesana
ideólogo	ideóloga
conseller	consellera
registrador	registradora
llanero	llanera
redentor	redentora
cabrito	cabrita
bisnieto	bisnieta
tuerto	tuerta
florentino	florentina
corsario	corsaria
pupilo	pupila
musicólogo	musicóloga
kurdo	kurda
conciliador	conciliadora
impostor	impostora
chiquillo	chiquilla
repetidor	repetidora
suburbano	suburbana
contralor	contralora
recolector	recolectora
imitador	imitadora
analfabeto	analfabeta
suscriptor	suscriptora
probador	probadora
inexperto	inexperta
napolitano	napolitana
armador	armadora
iberoamericano	iberoamericana
siciliano	siciliana
reformador	reformadora
proletario	proletaria
genovés	genovesa
retrógrado	retrógrada
vicerrector	vicerrectora
planificador	planificadora
hacedor	hacedora
espartano	espartana
novillero	novillera
chancho	chancha
zaragozano	zaragozana
fenicio	fenicia
hispanoamericano	hispanoamericana
bicampeón	bicampeona
salmantino	salmantina
converso	conversa
eurodiputado	eurodiputada
bávaro	bávara
cervecero	cervecera
gladiador	gladiadora
agraciado	agraciada
esquiador	esquiadora
pobrecito	pobrecita
búfalo	búfala
suramericano	suramericana
maltratador	maltratadora
insensato	insensata
sensato	sensata
drogadicto	drogadicta
becado	becada
lechero	lechera
tomador	tomadora
charro	charra
metalúrgico	metalúrgica
metalero	metalera
calculador	calculadora
criador	criadora
manufacturero	manufacturera
incomprendido	incomprendida
convicto	convicta
cartaginés	cartaginesa
tarado	tarada
mesero	mesera
mulato	mulata
avaro	avara
cartógrafo	cartógrafa
introvertido	introvertida
abusador	abusadora
activador	activadora
decorador	decoradora
surtidor	surtidora
examinador	examinadora
testador	testadora
asirio	asiria
visitador	visitadora
prestatario	prestataria
mejicano	mejicana
montañero	montañera
anunciador	anunciadora
remolcador	remolcadora
toscano	toscana
subalterno	subalterna
recaudador	recaudadora
vengador	vengadora
finado	finada
futbolero	futbolera
vicesecretario	vicesecretaria
hipopótamo	hipopótama
paralítico	paralítica
bebedor	bebedora
ochenteno	ochentena
escenógrafo	escenógrafa
xenófobo	xenófoba
cabezón	cabezona
normando	normanda
drogado	drogada
siberiano	siberiana
hawaiano	hawaiana
exsecretario	exsecretaria
chato	chata
recluso	reclusa
agnóstico	agnóstica
ingrato	ingrata
pijo	pija
borrego	borrega
desertor	desertora
jornalero	jornalera
benjamín	benjamina
transgresor	transgresora
codirector	codirectora
salsero	salsera
sádico	sádica
chiflado	chiflada
trepador	trepadora
desalojado	desalojada
micólogo	micóloga
fiador	fiadora
presumido	presumida
continuador	continuadora
colonizador	colonizadora
bandolero	bandolera
desamparado	desamparada
dador	dadora
preceptor	preceptora
oidor	oidora
lombardo	lombarda
neurótico	neurótica
hospedador	hospedadora
leproso	leprosa
súbdito	súbdita
pitufo	pitufa
meteorólogo	meteoróloga
sumerio	sumeria
titiritero	titiritera
filosofo	filosofa
jorobado	jorobada
pastelero	pastelera
entomólogo	entomóloga
pedófilo	pedófila
morisco	morisca
cholo	chola
occiso	occisa
suministrador	suministradora
esquizofrénico	esquizofrénica
explotador	explotadora
comunero	comunera
guarro	guarra
incendiario	incendiaria
segoviano	segoviana
carcelero	carcelera
victimario	victimaria
cobrador	cobradora
patinador	patinadora
tejano	tejana
gamberro	gamberra
manejador	manejadora
colchonero	colchonera
histérico	histérica
llorón	llorona
jónico	jónica
torturador	torturadora
anglicano	anglicana
ranchero	ranchera
checoslovaco	checoslovaca
samaritano	samaritana
visualizador	visualizadora
devorador	devoradora
templario	templaria
rastreador	rastreadora
montador	montadora
andador	andadora
miliciano	miliciana
poblador	pobladora
clasificador	clasificadora
estimulador	estimuladora
salesiano	salesiana
libertino	libertina
gregario	gregaria
pololo	polola
indoeuropeo	indoeuropea
euroasiático	euroasiática
eurasiático	eurasiática
telemático	telemática
plebeyo	plebeya
urólogo	uróloga
lechón	lechona
petardo	petarda
adepto	adepta
neurocirujano	neurocirujana
introductor	introductora
fariseo	farisea
evangelizador	evangelizadora
reboteador	reboteadora
trinitario	trinitaria
superdotado	superdotada
gruñón	gruñona
ortopédico	ortopédica
cochero	cochera
tranquilizador	tranquilizadora
cretino	cretina
necio	necia
terco	terca
obstinado	obstinada
testarudo	testaruda
oncólogo	oncóloga
encomendero	encomendera
coruñés	coruñesa
neonato	neonata
molinero	molinera
mañanero	mañanera
cantonés	cantonesa
mochilero	mochilera
exdiputado	exdiputada
supervillano	supervillana
superhéroe	superheroína
limonero	limonera
pichón	pichona
enólogo	enóloga
lacayo	lacaya
mamón	mamona
telonero	telonera
informador	informadora
arriero	arriera
mesoamericano	mesoamericana
boticario	boticaria
cantábrico	cantábrica
picador	picadora
muchachito	muchachita
hombrecito	mujercita
maño	maña
demagogo	demagoga
indiano	indiana
archivero	archivera
cuate	cuata
instigador	instigadora
afinador	afinadora
barquero	barquera
apático	apática
depravado	depravada
cateto	cateta
cancerbero	cancerbera
ario	aria
exterminador	exterminadora
texano	texana
patólogo	patóloga
tejedor	tejedora
rectificador	rectificadora
agrimensor	agrimensora
costeño	costeña
retardado	retardada
delator	delatora
acusador	acusadora
indocumentado	indocumentada
documentado	documentada
conspirador	conspiradora
excandidato	excandidata
celador	celadora
neófito	neófita
soriano	soriana
traumatólogo	traumatóloga
recuperador	recuperadora
tricampeón	tricampeona
vividor	vividora
peticionario	peticionaria
valedor	valedora
armero	armera
jurisconsulto	jurisconsulta
estimador	estimadora
mixteco	mixteca
milanés	milanesa
pardillo	pardilla
ribereño	ribereña
pirotécnico	pirotécnica
cosaco	cosaca
moroso	morosa
supresor	supresora
especulador	especuladora
reclutador	reclutadora
jefazo	jefaza
posadero	posadera
blasfemo	blasfema
tertuliano	tertuliana
maníaco	maníaca
fiscalizador	fiscalizadora
tatarabuelo	tatarabuela
copropietario	copropietaria
mellizo	melliza
perpetrador	perpetradora
freudiano	freudiana
donador	donadora
taquillero	taquillera
paramédico	paramédica
mormón	mormona
bodeguero	bodeguera
maquillador	maquilladora
captor	captora
novicio	novicia
rejoneador	rejoneadora
atracador	atracadora
doblador	dobladora
tipejo	tipeja
homofóbico	homofóbica
etnólogo	etnóloga
frigio	frigia
archivador	archivadora
substituto	substituta
malcriado	malcriada
tecnólogo	tecnóloga
primerizo	primeriza
montenegrino	montenegrina
tatuador	tatuadora
mamarracho	mamarracha
octogenario	octogenaria
puritano	puritana
egiptólogo	egiptóloga
aritmético	aritmética
carrocero	carrocera
lunático	lunática
tasador	tasadora
germanófobo	germanófona
vascófilo	vascófila
halterófilo	halterófila
anglófilo	anglófila
hispanófilo	hispanófila
enófilo	enófila
italianófilo	italianófila
cervantófilo	cervantófila
germanófilo	germanófila
rusófilo	rusófila
colombófilo	colombófila
pánfilo	pánfila
galófilo	galófila
negrófilo	negrófila
taurófilo	taurófila
indiófilo	indiófila
paidófilo	paidófila
aliadófilo	aliadófila
eurófilo	eurófila
eurocrítico	eurocrítica
euroescéptico	euroescépticoa
eurófobo	eurófobo
tránsfobo	tránsfoba
islamófobo	islamófoba
rusófobo	rusófoba
anglófobo	anglófoba
hispanófobo	hispanófoba
francófobo	francófoba
galófobo	galófoba
clerófobo	clerófoba
andrófobo	andrófoba
taurófobo	taurófoba
aerófobo	aerófoba
homófobo	homófoba
fotófobo	fotófoba
exprofesor	exprofesora
ex-profesor	ex-profesora
excoordinador	excoordinadora
ex-coordinador	ex-coordinadora
exlegislador	exlegisladora
ex-legislador	ex-legisladora
exluchador	exluchadora
ex-luchador	ex-luchadora
expelotero	expelotera
exdecano	exdecana
exeditor	exeditora
exadministrador	exadministradora
exnadador	exnadadora
experimentador	experimentadora
exclaustrado	exclaustrada
expoliador	expoliadora
azafato	azafata
charlatán	charlatana
germanófono	germanófona
francófono	francófona
anglófono	anglófona
portugalujo	portugaluja
lisbonés	lisbonesa
cocinerazo	cocineraza
cocineraso	cocinerasa
juglar	juglaresa
guardés	guardesa
salamanqués	salamanquesa
pequeñoburgués	pequeñoburguesa
conciudadano	conciudadana
institutor	institutriz
sastre	sastra
criollo	criolla
guapo	guapa
cabeceador	cabeceadora
embalador	embaladora
masón	masona
despierto	despierta
lagarto	lagarta
elefante	elefanta
venado	venada
ternero	ternera
cochino	cochina
jabalí	jabalina
cabezudo	cabezuda
delgaducho	delgaducha
flacucho	flacucha
medicucho	medicucha
enfermucho	enfermucha
larguirucho	larguirucha
delicaducho	delicaducha
meón	meona
fregón	fregona
muchachón	muchachona
matrón	matrona
sinvergonzón	sinvergonzona
pendejón	pendejona
pobretón	pobretona
trentón	trentona
cuarentón	cuarentona
cincuentón	cincuentona
ochentón	ochentona
gritón	gritona
gigantón	gigantona
valentón	valentona
gordinflón	gordinflona
gordiflón	gordiflona
bribón	bribona
fanfarrón	fanfarrona
replicón	replicona
poltrón	poltrona
chingón	chingona
huevón	huevona
mirón	mirona
chabón	chabona
chambón	chambona
soplón	soplona
empollón	empollona
bravucón	bravucona
burlón	burlona
zumbón	zumbona
guasón	guasona
vacilón	vacilona
mandón	mandona
tetracampeón	tetracampeona
multicampeón	multicampeona
excampeón	excampeona
ex-campeón	ex-campeona
ricachón	ricachona
ricacho	ricacha
tontorrón	tontorrona
gorrón	gorrona
bobalicón	bobalicona
buchón	buchona
comilón	comilona
comelón	comelona
zampón	zampona
tragón	tragona
copión	copiona
rajón	rajona
santurrón	santurrona
barbón	barbona
pechugón	pechugona
remendón	remendona
infanzón	infanzona
beberrón	beberrona
borrachón	borrachona
borrachín	borrachina
borrachito	borrachita
borrachuzo	borrachuza
respondón	respondona
cuarterón	cuarterona
grandulón	grandulona
grandullón	grandullona
simpaticón	simpaticona
querendón	querendona
señorón	señorona
retozón	retozona
lambón	lambona
adulón	adulona
fumón	fumona
pachón	pachona
barbudo	barbuda
bobo	boba
bobito	bobita
dadivoso	dadivosa
suegro	suegra
suegrito	suegrita
cuñadito	cuñadita
bisabuelito	bisabuelita
bisnietito	bisnietita
biznietito	biznietita
jovencillo	jovencilla
jovencito	jovencita
bebecito	bebecita
bebito	bebita
cieguito	cieguita
fulanito	fulanita
sobrinito	sobrinita
vecinito	vecinita
huerfanito	huerfanita
payasito	payasita
jefecito	jefecita
maestrito	maestrita
compañerito	compañerita
burguesito	burguesita
negrito	negrita
blanquito	blanquita
soldadito	soldadita
concejalito	concejalita
enfermito	enfermita
pastorcito	pastorcita
loquito	loquita
dormidito	dormidita
nerviosito	nerviosita
ocupadito	ocupadita
gordito	gordita
viejito	viejita
ancianito	ancianita
chinito	chinita
rusito	rusita
cubanito	cubanita
chilenito	chilenita
polaquito	polaquita
indito	indita
indiecito	indiecita
españolito	españolita
galleguito	galleguita
vasquito	vasquita
inglesito	inglesita
francesito	francesita
gringuito	gringuita
vaquerito	vaquerita
noviecito	noviecita
solterito	solterita
papasito	mamasita
geniecito	geniecita
enanito	enanita
diablito	diablita
monstruito	monstruita
vampirito	vampirita
brujito	brujita
robotito	robotita
marcianito	marcianita
chavito	chavita
güerito	güerita
pelirrojito	pelirrojita
rubiecito	rubiecita
rubito	rubita
peludito	peludita
enamoradito	enamoradita
puerquito	puerquita
chanchito	chanchita
cochinito	cochinita
lechoncito	lechoncita
leoncito	leoncita
tigrecito	tigrecita
elefantito	elefantita
venadito	venadita
ternerito	ternerita
putito	putita
pendejito	pendejita
guapote	guapota
guapito	guapita
amigote	amigota
diablote	diablota
payasote	payasota
muchachote	muchachota
neoyorquino	neoyorquina
muñeco	muñeca
muñequito	muñequita
ladronzuelo	ladronzuela
bribonzuelo	bribonzuela
jovenzuelo	jovenzuela
mozuelo	mozuela
muchachuelo	muchachuela
güero	güera
guero	guera
remero	remera
boludo	boluda
boludito	boludita
gaitero	gaitera
cumpleañero	cumpleañera
pandillero	pandillera
arequipeño	arequipeña
trujillano	trujillana
talareño	talareña
chiclayano	chiclayana
piurano	piurana
huaralino	huaralina
huancaíno	huancaína
huancaneño	huancaneña
huancavelicano	huancavelicana
chimbotano	chimbotana
pucallpino	pucallpina
pucallpeño	pucallpeña
juliaqueño	juliaqueña
ayacuchano	ayacuchana
pisqueño	pisqueña
cajamarquino	cajamarquina
huanuqueño	huanuqueña
punateño	punateña
iquiteño	iquiteña
lambayecano	lambayecana
huamanguino	huamanguina
chinchano	chinchana
loretano	loretana
cañetano	cañetana
sanromaneño	sanromaneña
pasqueño	pasqueña
tumbesino	tumbesina
chanchamayino	chanchamayina
chotano	chotana
ucayalino	ucayalina
ancashino	ancashina
cuzqueño	cuzqueña
cusqueño	cusqueña
tacneño	tacneña
doctrinario	doctrinaria
arreglador	arregladora
simpatizador	simpatizadora
educador	educadora
postilador	postiladora
megalómano	megalómana
costalero	costalera
presuntuoso	presuntuosa
marrano	marrana
choteador	choteadora
licántropo	licántropa
chivato	chivata
barrendero	barrendera
bibliófilo	bibliófila
mocoso	mocosa
gijonés	gijonesa
chiclanero	chiclanera
melómano	melómana
adorador	adoradora
apicultor	apicultora
acupuntor	acupuntora
bloggero	bloggera
chinampero	chinampera
demiurgo	demiurga
zapoteco	zapoteca
lusitano	lusitana
tanguero	tanguera
paleto	paleta
contestatario	contestataria
pacificador	pacificadora
energúmeno	energúmena
adiestrador	adiestradora
publicador	publicadora
represaliado	represaliada
entendedor	entendedora
usufructuario	usufructuaria
regiomontano	regiomontana
morocho	morocha
rufián	rufiana
timido	timida
forjador	forjadora
lugareño	lugareña
horticultor	horticultora
macaco	macaca
jarocho	jarocha
tabernero	tabernera
misántropo	misántropa
siamés	siamesa
radiólogo	radióloga
cuadragenario	cuadragenaria
tuitero	tuitera
maderero	maderera
amerindio	amerindia
topógrafo	topógrafa
huachafo	huachafa
donatario	donataria
repostero	repostera
naviero	naviera
falsificador	falsificadora
taxónomo	taxónoma
guajiro	guajira
dignatario	dignataria
malhechor	malhechora
inadaptado	inadaptada
convidado	convidada
coproductor	coproductora
cesionario	cesionaria
zorrillo	zorrilla
checheno	chechena
hospedero	hospedera
sonámbulo	sonámbula
etnógrafo	etnógrafa
viceconsejero	viceconsejera
usurero	usurera
preclasificado	preclasificada
comercializador	comercializadora
siríaco	siríaca
siriaco	siriaca
licitador	licitadora
ofensor	ofensora
librepensador	librepensadora
enseñador	enseñadora
exsenador	exsenadora
ex-senador	ex-senadora
avisador	avisadora
ventrílocuo	ventrílocua
exfuncionario	exfuncionaria
ex-funcionario	ex-funcionaria
replicador	replicadora
escolástico	escolástica
geofísico	geofísica
briólogo	brióloga
catador	catadora
liquidador	liquidadora
piamontés	piamontesa
configurador	configuradora
porteador	porteadora
sexólogo	sexóloga
morador	moradora
quisquilloso	quisquillosa
lexicógrafo	lexicógrafa
asilado	asilada
asalariado	asalariada
detractor	detractora
tataranieto	tataranieta
destripador	destripadora
chamaco	chamaca
apostador	apostadora
aparejador	aparejadora
caucásico	caucásica
librador	libradora
revendedor	revendedora
cacereño	cacereña
ufólogo	ufóloga
afilador	afiladora
monopólico	monopólica
cantinero	cantinera
timador	timadora
acólito	acólita
tracio	tracia
alsaciano	alsaciana
correligionario	correligionaria
pelador	peladora
pamplonés	pamplonesa
amnésico	amnésica
puntano	puntana
perezoso	perezosa
gascón	gascona
diablillo	diablilla
grafitero	grafitera
filisteo	filistea
perceptor	perceptora
patatero	patatera
tacaño	tacaña
mezquino	mezquina
mesquino	mesquina
desvergonzado	desvergonzada
vicedecano	vicedecana
celtíbero	celtíbera
celtibero	celtibera
comediógrafo	comediógrafa
asmático	asmática
jacobino	jacobina
sombrerero	sombrerera
democristiano	democristiana
calígrafo	calígrafa
hipnotizador	hipnotizadora
contertulio	contertulia
capacitador	capacitadora
chicano	chicana
cebuano	cebuana
recopilador	recopiladora
removedor	removedora
coeditor	coeditora
franquiciador	franquiciadora
partisano	partisana
encuestador	encuestadora
interrogador	interrogadora
veinteañero	veinteañera
treintañero	treintañera
gastrónomo	gastrónoma
pedorro	pedorra
anestesiólogo	anestesióloga
algólogo	algóloga
urbanizador	urbanizadora
forofo	forofa
chaparro	chaparra
teleoperador	teleoperadora
botellero	botellera
valón	valona
travestido	travestida
suevo	sueva
radioaficionado	radioaficionada
subprocurador	subprocuradora
acordeonero	acordeonera
araucano	araucana
carretillero	carretillera
actuario	actuaria
fueguino	fueguina
beduino	beduina
demostrador	demostradora
sustentador	sustentadora
adúltero	adúltera
podólogo	podóloga
masturbador	masturbadora
barranquillero	barranquillera
celiaco	celiaca
celíaco	celíaca
endocrinólogo	endocrinóloga
ojeador	ojeadora
modelador	modeladora
legatario	legataria
pirómano	pirómana
frisón	frisona
maniaco	maniaca
filibustero	filibustera
viticultor	viticultora
repoblador	repobladora
bellaco	bellaca
madrugador	madrugadora
pontevedrés	pontevedresa
exasesor	exasesora
ex-asesor	ex-asesora
surfero	surfera
guineo	guinea
objetor	objetora
licenciatario	licenciataria
licenciado	licenciada
merenguero	merenguera
comentador	comentadora
prestidigitador	prestidigitadora
labriego	labriega
pizzero	pizzera
cultor	cultora
invalido	invalida
inválido	inválida
condiscípulo	condiscípula
bibliógrafo	bibliógrafa
eliminador	eliminadora
consignatario	consignataria
signatario	signataria
adulador	aduladora
locatario	locataria
santandereano	santandereana
pitagórico	pitagórica
terminador	terminadora
iletrado	iletrada
castigador	castigadora
litógrafo	litógrafa
tahitiano	tahitiana
aguador	aguadora
wagneriano	wagneriana
biznieto	biznieta
pordiosero	pordiosera
extorsionador	extorsionadora
feroés	feroesa
hipocondríaco	hipocondríaca
hipocondriaco	hipocondriaca
socialcristiano	socialcristiana
fedatario	fedataria
epidemiólogo	epidemióloga
reguetonero	reguetonera
saqueador	saqueadora
vicejefe	vicejefa
bienhechor	bienhechora
malandro	malandra
malandrín	malandrina
ratero	ratera
comiquero	comiquera
conuquero	conuquera
bacteriólogo	bacterióloga
expendedor	expendedora
gastroenterólogo	gastroenteróloga
levantador	levantadora
sedicioso	sediciosa
amotinador	amotinadora
abonado	abonada
infrascrito	infrascrita
subscriptor	subscriptora
suscritor	suscritora
subscritor	subscritora
vallecaucano	vallecaucana
cananeo	cananea
hornero	hornera
prebenjamín	prebenjamina
lencero	lencera
aranés	aranesa
tebano	tebana
improvisador	improvisadora
puneño	puneña
saboteador	saboteadora
ostrogodo	ostrogoda
cocalero	cocalera
tamborilero	tamborilera
otorrinolaringólogo	otorrinolaringóloga
algodonero	algodonera
feligrés	feligresa
parroquiano	parroquiana
telespectador	telespectadora
copiador	copiadora
taponador	taponadora
quinceañero	quinceañera
quincuagenario	quincuagenaria
sexagenario	sexagenaria
bernés	bernesa
entintador	entintadora
mitómano	mitómana
despachador	despachadora
sesentero	sesentera
setentero	setentera
oriolano	oriolana
sabanero	sabanera
friulano	friulana
polinesio	polinesia
santiaguero	santiaguera
oceanógrafo	oceanógrafa
estibador	estibadora
segador	segadora
propagador	propagadora
billonario	billonaria
multibillonario	multibillonaria
jerónimo	jerónima
choricero	choricera
auspiciador	auspiciadora
reumatólogo	reumatóloga
cementero	cementera
arrocero	arrocera
pollino	pollina
ovejero	ovejera
exembajador	exembajadora
ex-embajador	ex-embajadora
acomodador	acomodadora
invocador	invocadora
aullador	aulladora
antólogo	antóloga
sismólogo	sismóloga
abstemio	abstemia
agorero	agorera
zángano	zángana
alcahuete	alcahueta
almacenero	almacenera
guayanés	guayanesa
potentado	potentada
balinés	balinesa
tallador	talladora
majadero	majadera
geotécnico	geotécnica
anticristiano	anticristiana
anti-cristiano	anti-cristiana
septuagenario	septuagenaria
avilesino	avilesina
kinesiólogo	kinesióloga
bilbaíno	bilbaina
senyor	senyora
retrogrado	retrograda
heladero	heladera
amador	amadora
prosecretario	prosecretaria
mengano	mengana
batero	batera
gabacho	gabacha
pucelano	pucelana
borgoñón	borgoñona
pocho	pocha
groenlandés	groenlandesa
dinamarqués	dinamarquesa
semiólogo	semióloga
bachatero	bachatera
ferrocarrilero	ferrocarrilera
pampeano	pampeana
atunero	atunera
prostituto	prostituta
cuentero	cuentera
avilés	avilesa
murciano	murciana
fideicomisario	fideicomisaria
panfletario	panfletaria
tapicero	tapicera
partero	partera
mesonero	mesonera
exrector	exrectora
ex-rector	ex-rectora
portorriqueño	portorriqueña
climatólogo	climatóloga
colectivero	colectivera
ictiólogo	ictióloga
vidriero	vidriera
chalado	chalada
sonso	sonsa
zonzo	zonza
tirolés	tirolesa
rumbero	rumbera
rutero	rutera
mirandés	mirandesa
guardador	guardadora
violero	violera
sillero	sillera
rociero	rociera
martillero	martillera
subastador	subastadora
melenudo	melenuda
descargador	descargadora
gibraltareño	gibraltareña
sahariano	sahariana
cosmólogo	cosmóloga
adivinador	adivinadora
boloñés	boloñesa
cartonero	cartonera
trampero	trampera
chatarrero	chatarrera
plagiador	plagiadora
epicúreo	epicúrea
talaverano	talaverana
cocreador	cocreadora
co-creador	co-creadora
palero	palera
acaparador	acaparadora
defraudador	defraudadora
taumaturgo	taumaturga
macabeo	macabea
cuáquero	cuáquera
juguetero	juguetera
dorador	doradora
excavador	excavadora
quisqueyano	quisqueyana
etólogo	etóloga
extracomunitario	extracomunitaria
neoconservador	neoconservadora
partidor	partidora
quebequés	quebequesa
lorquino	lorquina
utilero	utilera
mielero	mielera
vulcanólogo	vulcanóloga
destilador	destiladora
catracho	catracha
alcalaíno	alcalaína
boyero	boyera
festero	festera
fiestero	fiestera
farrero	farrera
marsellés	marsellesa
javanés	javanesa
exalumno	exalumna
ex-alumno	ex-alumna
parapsicólogo	parapsicóloga
parasicólogo	parasicóloga
psicasténico	psicasténica
sicasténico	sicasténica
norteamericano	norteamericana
nativoamericano	nativoamericana
cubanoamericano	cubanoamericana
italoamericano	italoamericana
indoamericano	indoamericana
exesposo	exesposa
ex-esposo	ex-esposa
nutriólogo	nutrióloga
quiosquero	quiosquera
kiosquero	kiosquera
véneto	véneta
nonagenario	nonagenaria
notificador	notificadora
plantador	plantadora
buhonero	buhonera
ribagorzano	ribagorzana
tuberculoso	tuberculosa
galaico	galaica
conseguidor	conseguidora
carabobeño	carabobeña
herpetólogo	herpetóloga
trapero	trapera
párvulo	párvula
originador	originadora
viñamarino	viñamarina
utrerano	utrerana
sinólogo	sinóloga
transilvano	transilvana
notero	notera
ourensano	ourensana
orensano	orensana
neumólogo	neumóloga
falsario	falsaria
palurdo	palurda
calabrés	calabresa
politiquero	politiquera
chalaco	chalaca
valdiviano	valdiviana
cantador	cantadora
loquero	loquera
nubio	nubia
cristero	cristera
majorero	majorera
apoyador	apoyadora
exdirectivo	exdirectiva
ex-directivo	ex-directiva
fallador	falladora
rifeño	rifeña
exempleado	exempleada
ex-empleado	ex-empleada
farmacólogo	farmacóloga
alergólogo	alergóloga
britano	britana
tunero	tunera
cuencano	cuencana
pasiego	pasiega
consuegro	consuegra
hematólogo	hematóloga
lanzaroteño	lanzaroteña
chuquisaqueño	chuquisaqueña
inmunólogo	inmunóloga
arrabalero	arrabalera
blusero	blusera
bausero	bausera
recadero	recadera
meditador	meditadora
girador	giradora
moldeador	moldeadora
angevino	angevina
cátaro	cátara
cachaco	cachaca
vascón	vascona
segundogénito	segundogénita
plagiario	plagiaria
pequinés	pequinesa
amorreo	amorrea
demógrafo	demógrafa
mafufo	mafufa
magufo	magufa
nefrólogo	nefróloga
deshollinador	deshollinadora
baqueano	baqueana
baquiano	baquiana
vaqueano	vaqueana
angloamericano	angloamericana
paseador	paseadora
porquero	porquera
virginiano	virginiana
vermontés	vermontesa
caminador	caminadora
tarasco	tarasca
pastillero	pastillera
seor	seora
escolapio	escolapia
organero	organera
epistemólogo	epistemóloga
graffitero	graffitera
abisinio	abisinia
aquitano	aquitana
curtidor	curtidora
enunciador	enunciadora
alcoyano	alcoyana
beodo	beoda
ebrio	ebria
embriagador	embriagadora
dipsomaníaco	dipsomaníaca
dipsomaniaco	dipsomaniaca
dulcero	dulcera
confitero	confitera
fisicoquímico	fisicoquímica
taquígrafo	taquígrafa
prevaricador	prevaricadora
logroñés	logroñesa
sanmarquino	sanmarquina
sanmarqueño	sanmarqueña
picapedrero	picapedrera
jabato	jabata
temporero	temporera
bordador	bordadora
holguinero	holguinera
postulador	postuladora
virólogo	viróloga
tintorero	tintorera
declamador	declamadora
cuestionador	cuestionadora
pastuso	pastusa
osco	osca
transcriptor	transcriptora
touroperador	touroperadora
sacador	sacadora
concuñado	concuñada
copresentador	copresentadora
follamigo	follamiga
antequerano	antequerana
lojano	lojana
medianero	medianera
apilador	apiladora
europarlamentario	europarlamentaria
exprocurador	exprocuradora
comunicólogo	comunicóloga
pipiolo	pipiola
mecanógrafo	mecanógrafa
pisano	pisana
geoquímico	geoquímica
rodador	rodadora
parrandero	parrandera
sodero	sodera
criptógrafo	criptógrafa
neurobiólogo	neurobióloga
prehistoriador	prehistoriadora
nortino	nortina
historiógrafo	historiógrafa
ilirio	iliria
peinero	peinera
confuciano	confuciana
cardiologo	cardiologa
ruteno	rutena
anoréxico	anoréxica
coplero	coplera
lépero	lépera
marchoso	marchosa
agroquímico	agroquímica
charnego	charnega
pulpero	pulpera
dacio	dacia
rotario	rotaria
gallero	gallera
nabateo	nabatea
neuropsicólogo	neuropsicóloga
neurosicólogo	neurosicóloga
vetón	vetona
ejidatario	ejidataria
teotihuacano	teotihuacana
margariteño	margariteña
sanluqueño	sanluqueña
camagüeyano	camagüeyana
incitador	incitadora
codescubridor	codescubridora
liniero	liniera
detentador	detentadora
marchador	marchadora
legitimario	legitimaria
leguleyo	leguleya
congolés	congolesa
mamporrero	mamporrera
difamador	difamadora
alano	alana
churrero	churrera
guantanamero	guantanamera
peletero	peletera
bordelés	bordelesa
expósito	expósita
contemplador	contempladora
güelfo	güelfa
resinero	resinera
alpujarreño	alpujarreña
prosélito	prosélita
galapagueño	galapagueña
pornógrafo	pornógrafa
mercadólogo	mercadóloga
contradictor	contradictora
consumador	consumadora
hojalatero	hojalatera
castellanoleonés	castellanoleonesa
afroperuano	afroperuana
alfabetizador	alfabetizadora
especificador	especificadora
numantino	numantina
cocainómano	cocainómana
exconvicto	exconvicta
ex-convicto	ex-convicta
hagiógrafo	hagiógrafa
futurólogo	futuróloga
igualador	igualadora
museólogo	museóloga
peripatético	peripatética
entregador	entregadora
trompetero	trompetera
balsero	balsera
gibelino	gibelina
padrote	madrota
embotellador	embotelladora
infectólogo	infectóloga
farolero	farolera
lisonjero	lisonjera
herreño	herreña
entallador	entalladora
fitogeógrafo	fitogeógrafa
lidiador	lidiadora
mazateco	mazateca
moguereño	moguereña
cristalero	cristalera
trovero	trovera
perfeccionador	perfeccionadora
carteador	carteadora
valaco	valaca
matrero	matrera
herrador	herradora
decidor	decidora
necrófilo	necrófila
abejero	abejera
catalogador	catalogadora
anti-americano	anti-americana
extrabajador	extrabajadora
ex-trabajador	ex-trabajadora
aguatero	aguatera
campirano	campirana
nene	nena
esparcidor	esparcidora
ampurdanés	ampurdanesa
caucasiano	caucasiana
teósofo	teósofa
lorenés	lorenesa
atacameño	atacameña
santaneco	santaneca
aragüeño	aragüeña
usurario	usuraria
zopenco	zopenca
cuatrero	cuatrera
iquiqueño	iquiqueña
aparcero	aparcera
sardinero	sardinera
chero	chera
suplidor	suplidora
abastecedor	abastecedora
cuchillero	cuchillera
licio	licia
iroqués	iroquesa
saboyano	saboyana
avaricioso	avariciosa
cosechero	cosechera
judeoconverso	judeoconversa
pedigüeño	pedigüeña
maracucho	maracucha
maracaibero	maracaibera
hilandero	hilandera
despensero	despensera
villaclareño	villaclareña
reconocedor	reconocedora
taquero	taquera
pocero	pocera
gondolero	gondolera
tonelero	tonelera
graciano	graciana
huertano	huertana
fajador	fajadora
palomero	palomera
ayoreo	ayorea
gastador	gastadora
componedor	componedora
ensayador	ensayadora
estomatólogo	estomatóloga
ecijano	ecijana
intimidador	intimidadora
burkinés	burkinesa
tabaquero	tabaquera
chinchalero	chinchalera
guiador	guiadora
musicalizador	musicalizadora
tocopillano	tocopillana
corifeo	corifea
ariqueño	ariqueña
coheredero	coheredera
recreador	recreadora
esmeraldeño	esmeraldeña
funebrero	funebrera
hidrógrafo	hidrógrafa
cacaotero	cacaotera
catecúmeno	catecúmena
dogón	dogona
lanero	lanera
tocaor	tocaora
tramitador	tramitadora
hachero	hachera
moloso	molosa
planchador	planchadora
neurofisiólogo	neurofisióloga
pachuco	pachuca
fletador	fletadora
auxiliador	auxiliadora
censurador	censuradora
micho	micha
neonatólogo	neonatóloga
escrutador	escrutadora
asignatario	asignataria
embriólogo	embrióloga
iqueño	iqueña
cangrejero	cangrejera
asistidor	asistidora
carmelitano	carmelitana
veronés	veronesa
dinamitero	dinamitera
aracnólogo	aracnóloga
envenenador	envenenadora
milonguero	milonguera
fonoaudiólogo	fonoaudióloga
latero	latera
suplantador	suplantadora
vacano	vacana
novelero	novelera
bígamo	bígama
mitólogo	mitóloga
coriano	coriana
incumplidor	incumplidora
asgardiano	asgardiana
chaquetero	chaquetera
timbalero	timbalera
viñador	viñadora
reseñador	reseñadora
desclasado	desclasada
santafereño	santafereña
cumano	cumana
cienfueguero	cienfueguera
istmeño	istmeña
frisio	frisia
paleógrafo	paleógrafa
baturro	baturra
influenciador	influenciadora
acechador	acechadora
lucentino	lucentina
prospector	prospectora
guanacasteco	guanacasteca
argivo	argiva
museógrafo	museógrafa
cetrero	cetrera
imperador	imperadora
misionario	misionaria
escuincle	escuincla
pinolero	pinolera
concertador	concertadora
asunceno	asuncena
telepredicador	telepredicadora
melero	melera
contuso	contusa
fitopatólogo	fitopatóloga
toxicólogo	toxicóloga
heroinómano	heroinómana
miraflorino	miraflorina
cabildero	cabildera
coorganizador	coorganizadora
castellanomanchego	castellanomanchega
primatólogo	primatóloga
sienés	sienesa
antologador	antologadora
herediano	herediana
descifrador	descifradora
palermitano	palermitana
indagador	indagadora
coescritor	coescritora
tudelano	tudelana
tañedor	tañedora
bibliotecólogo	bibliotecóloga
escanciador	escanciadora
riobambeño	riobambeña
malacólogo	malacóloga
baezano	baezana
podador	podadora
facineroso	facinerosa
tocario	tocaria
meteco	meteca
apureño	apureña
moreliano	moreliana
esenio	esenia
autobusero	autobusera
puestero	puestera
chulapo	chulapa
zutano	zutana
mitógrafo	mitógrafa
cucuteño	cucuteña
henequenero	henequenera
carpetano	carpetana
roncalés	roncalesa
tripero	tripera
floricultor	floricultora
longobardo	longobarda
versificador	versificadora
ruletero	ruletera
cuadripléjico	cuadripléjica
tetrapléjico	tetrapléjica
algonquino	algonquina
sayagués	sayaguesa
tocólogo	tocóloga
opinólogo	opinóloga
